Cód. IBGE;Localidades;Períodos;Leitos;Leitos (Coeficiente por mil habitantes);Leitos SUS;Leitos SUS (Coeficiente por mil habitantes);Leitos Não SUS;Leitos Não SUS (Coeficiente por mil habitantes)
3500105;Adamantina;2010;308;9,11;271;8,02;37;1,09
3500105;Adamantina;2011;308;9,11;271;8,02;37;1,09
3500105;Adamantina;2012;300;8,87;263;7,77;37;1,09
3500105;Adamantina;2013;284;8,39;240;7,09;44;1,3
3500105;Adamantina;2014;279;8,24;240;7,09;39;1,15
3500105;Adamantina;2015;279;8,24;240;7,08;39;1,15
3500105;Adamantina;2016;279;8,23;240;7,08;39;1,15
3500105;Adamantina;2017;258;7,61;219;6,46;39;1,15
3500105;Adamantina;2018;258;7,61;219;6,46;39;1,15
3500105;Adamantina;2019;235;6,93;206;6,08;29;0,86
3500204;Adolfo;2010;0;0;0;0;0;0
3500204;Adolfo;2011;0;0;0;0;0;0
3500204;Adolfo;2012;0;0;0;0;0;0
3500204;Adolfo;2013;0;0;0;0;0;0
3500204;Adolfo;2014;0;0;0;0;0;0
3500204;Adolfo;2015;0;0;0;0;0;0
3500204;Adolfo;2016;0;0;0;0;0;0
3500204;Adolfo;2017;0;0;0;0;0;0
3500204;Adolfo;2018;0;0;0;0;0;0
3500204;Adolfo;2019;0;0;0;0;0;0
3500303;Aguaí;2010;76;2,37;49;1,53;27;0,84
3500303;Aguaí;2011;76;2,34;49;1,51;27;0,83
3500303;Aguaí;2012;76;2,32;49;1,49;27;0,82
3500303;Aguaí;2013;0;0;0;0;0;0
3500303;Aguaí;2014;0;0;0;0;0;0
3500303;Aguaí;2015;0;0;0;0;0;0
3500303;Aguaí;2016;10;0,29;0;0;10;0,29
3500303;Aguaí;2017;10;0,29;0;0;10;0,29
3500303;Aguaí;2018;10;0,29;0;0;10;0,29
3500303;Aguaí;2019;0;0;0;0;0;0
3500402;Águas da Prata;2010;0;0;0;0;0;0
3500402;Águas da Prata;2011;0;0;0;0;0;0
3500402;Águas da Prata;2012;0;0;0;0;0;0
3500402;Águas da Prata;2013;0;0;0;0;0;0
3500402;Águas da Prata;2014;0;0;0;0;0;0
3500402;Águas da Prata;2015;0;0;0;0;0;0
3500402;Águas da Prata;2016;0;0;0;0;0;0
3500402;Águas da Prata;2017;0;0;0;0;0;0
3500402;Águas da Prata;2018;0;0;0;0;0;0
3500402;Águas da Prata;2019;0;0;0;0;0;0
3500501;Águas de Lindóia;2010;42;2,43;30;1,74;12;0,7
3500501;Águas de Lindóia;2011;42;2,42;30;1,73;12;0,69
3500501;Águas de Lindóia;2012;42;2,4;30;1,71;12;0,69
3500501;Águas de Lindóia;2013;42;2,39;30;1,7;12;0,68
3500501;Águas de Lindóia;2014;42;2,37;30;1,69;12;0,68
3500501;Águas de Lindóia;2015;42;2,35;30;1,68;12;0,67
3500501;Águas de Lindóia;2016;42;2,34;30;1,67;12;0,67
3500501;Águas de Lindóia;2017;42;2,33;30;1,66;12;0,66
3500501;Águas de Lindóia;2018;42;2,31;30;1,65;12;0,66
3500501;Águas de Lindóia;2019;42;2,3;30;1,64;12;0,66
3500550;Águas de Santa Bárbara;2010;0;0;0;0;0;0
3500550;Águas de Santa Bárbara;2011;0;0;0;0;0;0
3500550;Águas de Santa Bárbara;2012;0;0;0;0;0;0
3500550;Águas de Santa Bárbara;2013;0;0;0;0;0;0
3500550;Águas de Santa Bárbara;2014;0;0;0;0;0;0
3500550;Águas de Santa Bárbara;2015;0;0;0;0;0;0
3500550;Águas de Santa Bárbara;2016;0;0;0;0;0;0
3500550;Águas de Santa Bárbara;2017;0;0;0;0;0;0
3500550;Águas de Santa Bárbara;2018;0;0;0;0;0;0
3500550;Águas de Santa Bárbara;2019;0;0;0;0;0;0
3500600;Águas de São Pedro;2010;0;0;0;0;0;0
3500600;Águas de São Pedro;2011;4;1,46;4;1,46;0;0
3500600;Águas de São Pedro;2012;4;1,43;4;1,43;0;0
3500600;Águas de São Pedro;2013;4;1,41;4;1,41;0;0
3500600;Águas de São Pedro;2014;4;1,39;4;1,39;0;0
3500600;Águas de São Pedro;2015;4;1,37;4;1,37;0;0
3500600;Águas de São Pedro;2016;4;1,35;4;1,35;0;0
3500600;Águas de São Pedro;2017;0;0;0;0;0;0
3500600;Águas de São Pedro;2018;0;0;0;0;0;0
3500600;Águas de São Pedro;2019;0;0;0;0;0;0
3500709;Agudos;2010;65;1,88;43;1,25;22;0,64
3500709;Agudos;2011;65;1,87;43;1,24;22;0,63
3500709;Agudos;2012;65;1,87;43;1,23;22;0,63
3500709;Agudos;2013;65;1,86;43;1,23;22;0,63
3500709;Agudos;2014;60;1,7;38;1,08;22;0,63
3500709;Agudos;2015;60;1,7;38;1,07;22;0,62
3500709;Agudos;2016;60;1,69;38;1,07;22;0,62
3500709;Agudos;2017;60;1,68;38;1,07;22;0,62
3500709;Agudos;2018;60;1,67;38;1,06;22;0,61
3500709;Agudos;2019;60;1,67;38;1,06;22;0,61
3500758;Alambari;2010;0;0;0;0;0;0
3500758;Alambari;2011;0;0;0;0;0;0
3500758;Alambari;2012;0;0;0;0;0;0
3500758;Alambari;2013;0;0;0;0;0;0
3500758;Alambari;2014;0;0;0;0;0;0
3500758;Alambari;2015;0;0;0;0;0;0
3500758;Alambari;2016;0;0;0;0;0;0
3500758;Alambari;2017;0;0;0;0;0;0
3500758;Alambari;2018;0;0;0;0;0;0
3500758;Alambari;2019;0;0;0;0;0;0
3500808;Alfredo Marcondes;2010;0;0;0;0;0;0
3500808;Alfredo Marcondes;2011;0;0;0;0;0;0
3500808;Alfredo Marcondes;2012;0;0;0;0;0;0
3500808;Alfredo Marcondes;2013;0;0;0;0;0;0
3500808;Alfredo Marcondes;2014;0;0;0;0;0;0
3500808;Alfredo Marcondes;2015;0;0;0;0;0;0
3500808;Alfredo Marcondes;2016;0;0;0;0;0;0
3500808;Alfredo Marcondes;2017;0;0;0;0;0;0
3500808;Alfredo Marcondes;2018;0;0;0;0;0;0
3500808;Alfredo Marcondes;2019;0;0;0;0;0;0
3500907;Altair;2010;0;0;0;0;0;0
3500907;Altair;2011;0;0;0;0;0;0
3500907;Altair;2012;0;0;0;0;0;0
3500907;Altair;2013;0;0;0;0;0;0
3500907;Altair;2014;0;0;0;0;0;0
3500907;Altair;2015;0;0;0;0;0;0
3500907;Altair;2016;0;0;0;0;0;0
3500907;Altair;2017;0;0;0;0;0;0
3500907;Altair;2018;0;0;0;0;0;0
3500907;Altair;2019;0;0;0;0;0;0
3501004;Altinópolis;2010;30;1,92;21;1,35;9;0,58
3501004;Altinópolis;2011;30;1,92;21;1,35;9;0,58
3501004;Altinópolis;2012;30;1,92;21;1,35;9;0,58
3501004;Altinópolis;2013;31;1,99;25;1,6;6;0,39
3501004;Altinópolis;2014;31;1,99;25;1,61;6;0,39
3501004;Altinópolis;2015;31;1,99;25;1,61;6;0,39
3501004;Altinópolis;2016;31;1,99;25;1,61;6;0,39
3501004;Altinópolis;2017;31;1,99;25;1,61;6;0,39
3501004;Altinópolis;2018;31;1,99;25;1,61;6;0,39
3501004;Altinópolis;2019;31;1,99;25;1,61;6;0,39
3501103;Alto Alegre;2010;22;5,36;19;4,63;3;0,73
3501103;Alto Alegre;2011;22;5,37;19;4,64;3;0,73
3501103;Alto Alegre;2012;22;5,38;19;4,65;3;0,73
3501103;Alto Alegre;2013;22;5,39;19;4,65;3;0,73
3501103;Alto Alegre;2014;22;5,4;19;4,66;3;0,74
3501103;Alto Alegre;2015;22;5,41;19;4,67;3;0,74
3501103;Alto Alegre;2016;22;5,42;19;4,68;3;0,74
3501103;Alto Alegre;2017;22;5,44;19;4,69;3;0,74
3501103;Alto Alegre;2018;22;5,45;19;4,71;3;0,74
3501103;Alto Alegre;2019;22;5,46;19;4,72;3;0,74
3501152;Alumínio;2010;0;0;0;0;0;0
3501152;Alumínio;2011;0;0;0;0;0;0
3501152;Alumínio;2012;0;0;0;0;0;0
3501152;Alumínio;2013;0;0;0;0;0;0
3501152;Alumínio;2014;0;0;0;0;0;0
3501152;Alumínio;2015;0;0;0;0;0;0
3501152;Alumínio;2016;0;0;0;0;0;0
3501152;Alumínio;2017;0;0;0;0;0;0
3501152;Alumínio;2018;0;0;0;0;0;0
3501152;Alumínio;2019;0;0;0;0;0;0
3501202;Álvares Florence;2010;0;0;0;0;0;0
3501202;Álvares Florence;2011;0;0;0;0;0;0
3501202;Álvares Florence;2012;0;0;0;0;0;0
3501202;Álvares Florence;2013;0;0;0;0;0;0
3501202;Álvares Florence;2014;0;0;0;0;0;0
3501202;Álvares Florence;2015;0;0;0;0;0;0
3501202;Álvares Florence;2016;0;0;0;0;0;0
3501202;Álvares Florence;2017;0;0;0;0;0;0
3501202;Álvares Florence;2018;0;0;0;0;0;0
3501202;Álvares Florence;2019;0;0;0;0;0;0
3501301;Álvares Machado;2010;20;0,85;18;0,77;2;0,09
3501301;Álvares Machado;2011;20;0,85;18;0,77;2;0,09
3501301;Álvares Machado;2012;20;0,85;18;0,76;2;0,08
3501301;Álvares Machado;2013;20;0,85;18;0,76;2;0,08
3501301;Álvares Machado;2014;20;0,85;18;0,76;2;0,08
3501301;Álvares Machado;2015;20;0,85;18;0,76;2;0,08
3501301;Álvares Machado;2016;20;0,85;18;0,76;2;0,08
3501301;Álvares Machado;2017;20;0,84;18;0,76;2;0,08
3501301;Álvares Machado;2018;20;0,84;18;0,76;2;0,08
3501301;Álvares Machado;2019;20;0,84;18;0,76;2;0,08
3501400;Álvaro de Carvalho;2010;0;0;0;0;0;0
3501400;Álvaro de Carvalho;2011;0;0;0;0;0;0
3501400;Álvaro de Carvalho;2012;0;0;0;0;0;0
3501400;Álvaro de Carvalho;2013;0;0;0;0;0;0
3501400;Álvaro de Carvalho;2014;0;0;0;0;0;0
3501400;Álvaro de Carvalho;2015;0;0;0;0;0;0
3501400;Álvaro de Carvalho;2016;0;0;0;0;0;0
3501400;Álvaro de Carvalho;2017;0;0;0;0;0;0
3501400;Álvaro de Carvalho;2018;0;0;0;0;0;0
3501400;Álvaro de Carvalho;2019;0;0;0;0;0;0
3501509;Alvinlândia;2010;0;0;0;0;0;0
3501509;Alvinlândia;2011;0;0;0;0;0;0
3501509;Alvinlândia;2012;0;0;0;0;0;0
3501509;Alvinlândia;2013;0;0;0;0;0;0
3501509;Alvinlândia;2014;0;0;0;0;0;0
3501509;Alvinlândia;2015;0;0;0;0;0;0
3501509;Alvinlândia;2016;0;0;0;0;0;0
3501509;Alvinlândia;2017;0;0;0;0;0;0
3501509;Alvinlândia;2018;0;0;0;0;0;0
3501509;Alvinlândia;2019;0;0;0;0;0;0
3501608;Americana;2010;619;2,94;388;1,84;231;1,1
3501608;Americana;2011;677;3,18;373;1,75;304;1,43
3501608;Americana;2012;686;3,18;343;1,59;343;1,59
3501608;Americana;2013;683;3,13;340;1,56;343;1,57
3501608;Americana;2014;702;3,18;340;1,54;362;1,64
3501608;Americana;2015;698;3,13;343;1,54;355;1,59
3501608;Americana;2016;640;2,84;251;1,11;389;1,73
3501608;Americana;2017;571;2,51;205;0,9;366;1,61
3501608;Americana;2018;571;2,49;205;0,89;366;1,6
3501608;Americana;2019;517;2,23;207;0,89;310;1,34
3501707;Américo Brasiliense;2010;240;6,97;240;6,97;0;0
3501707;Américo Brasiliense;2011;266;7,6;266;7,6;0;0
3501707;Américo Brasiliense;2012;264;7,41;264;7,41;0;0
3501707;Américo Brasiliense;2013;204;5,63;204;5,63;0;0
3501707;Américo Brasiliense;2014;204;5,53;204;5,53;0;0
3501707;Américo Brasiliense;2015;206;5,49;206;5,49;0;0
3501707;Américo Brasiliense;2016;230;6,05;230;6,05;0;0
3501707;Américo Brasiliense;2017;220;5,7;220;5,7;0;0
3501707;Américo Brasiliense;2018;198;5,06;198;5,06;0;0
3501707;Américo Brasiliense;2019;177;4,46;177;4,46;0;0
3501806;Américo de Campos;2010;0;0;0;0;0;0
3501806;Américo de Campos;2011;0;0;0;0;0;0
3501806;Américo de Campos;2012;0;0;0;0;0;0
3501806;Américo de Campos;2013;0;0;0;0;0;0
3501806;Américo de Campos;2014;0;0;0;0;0;0
3501806;Américo de Campos;2015;0;0;0;0;0;0
3501806;Américo de Campos;2016;0;0;0;0;0;0
3501806;Américo de Campos;2017;0;0;0;0;0;0
3501806;Américo de Campos;2018;0;0;0;0;0;0
3501806;Américo de Campos;2019;0;0;0;0;0;0
3501905;Amparo;2010;454;6,9;356;5,41;98;1,49
3501905;Amparo;2011;456;6,89;356;5,38;100;1,51
3501905;Amparo;2012;469;7,04;356;5,34;113;1,7
3501905;Amparo;2013;349;5,2;236;3,52;113;1,69
3501905;Amparo;2014;358;5,3;243;3,6;115;1,7
3501905;Amparo;2015;357;5,26;242;3,56;115;1,69
3501905;Amparo;2016;395;5,79;242;3,55;153;2,24
3501905;Amparo;2017;377;5,5;224;3,27;153;2,23
3501905;Amparo;2018;383;5,56;230;3,34;153;2,22
3501905;Amparo;2019;392;5,66;215;3,1;177;2,55
3502002;Analândia;2010;0;0;0;0;0;0
3502002;Analândia;2011;0;0;0;0;0;0
3502002;Analândia;2012;0;0;0;0;0;0
3502002;Analândia;2013;0;0;0;0;0;0
3502002;Analândia;2014;0;0;0;0;0;0
3502002;Analândia;2015;0;0;0;0;0;0
3502002;Analândia;2016;0;0;0;0;0;0
3502002;Analândia;2017;0;0;0;0;0;0
3502002;Analândia;2018;0;0;0;0;0;0
3502002;Analândia;2019;0;0;0;0;0;0
3502101;Andradina;2010;100;1,81;64;1,16;36;0,65
3502101;Andradina;2011;100;1,8;64;1,15;36;0,65
3502101;Andradina;2012;100;1,8;64;1,15;36;0,65
3502101;Andradina;2013;135;2,43;110;1,98;25;0,45
3502101;Andradina;2014;135;2,42;110;1,98;25;0,45
3502101;Andradina;2015;136;2,44;110;1,97;26;0,47
3502101;Andradina;2016;136;2,44;110;1,97;26;0,47
3502101;Andradina;2017;136;2,43;110;1,97;26;0,47
3502101;Andradina;2018;127;2,27;91;1,63;36;0,64
3502101;Andradina;2019;127;2,27;91;1,63;36;0,64
3502200;Angatuba;2010;57;2,57;54;2,43;3;0,14
3502200;Angatuba;2011;57;2,54;54;2,41;3;0,13
3502200;Angatuba;2012;57;2,52;54;2,38;3;0,13
3502200;Angatuba;2013;57;2,49;54;2,36;3;0,13
3502200;Angatuba;2014;57;2,47;54;2,34;3;0,13
3502200;Angatuba;2015;57;2,44;54;2,31;3;0,13
3502200;Angatuba;2016;57;2,42;54;2,29;3;0,13
3502200;Angatuba;2017;57;2,39;54;2,27;3;0,13
3502200;Angatuba;2018;57;2,37;54;2,25;3;0,12
3502200;Angatuba;2019;57;2,35;54;2,23;3;0,12
3502309;Anhembi;2010;0;0;0;0;0;0
3502309;Anhembi;2011;0;0;0;0;0;0
3502309;Anhembi;2012;0;0;0;0;0;0
3502309;Anhembi;2013;0;0;0;0;0;0
3502309;Anhembi;2014;0;0;0;0;0;0
3502309;Anhembi;2015;0;0;0;0;0;0
3502309;Anhembi;2016;0;0;0;0;0;0
3502309;Anhembi;2017;0;0;0;0;0;0
3502309;Anhembi;2018;0;0;0;0;0;0
3502309;Anhembi;2019;0;0;0;0;0;0
3502408;Anhumas;2010;0;0;0;0;0;0
3502408;Anhumas;2011;0;0;0;0;0;0
3502408;Anhumas;2012;0;0;0;0;0;0
3502408;Anhumas;2013;0;0;0;0;0;0
3502408;Anhumas;2014;0;0;0;0;0;0
3502408;Anhumas;2015;0;0;0;0;0;0
3502408;Anhumas;2016;0;0;0;0;0;0
3502408;Anhumas;2017;0;0;0;0;0;0
3502408;Anhumas;2018;0;0;0;0;0;0
3502408;Anhumas;2019;0;0;0;0;0;0
3502507;Aparecida;2010;84;2,4;50;1,43;34;0,97
3502507;Aparecida;2011;84;2,39;50;1,43;34;0,97
3502507;Aparecida;2012;84;2,39;50;1,42;34;0,97
3502507;Aparecida;2013;84;2,39;50;1,42;34;0,97
3502507;Aparecida;2014;104;2,95;70;1,98;34;0,96
3502507;Aparecida;2015;104;2,94;70;1,98;34;0,96
3502507;Aparecida;2016;104;2,94;70;1,98;34;0,96
3502507;Aparecida;2017;104;2,93;70;1,97;34;0,96
3502507;Aparecida;2018;104;2,92;70;1,97;34;0,96
3502507;Aparecida;2019;104;2,92;70;1,96;34;0,95
3502606;Aparecida d'Oeste;2010;30;6,74;8;1,8;22;4,94
3502606;Aparecida d'Oeste;2011;30;6,79;8;1,81;22;4,98
3502606;Aparecida d'Oeste;2012;30;6,84;8;1,82;22;5,02
3502606;Aparecida d'Oeste;2013;30;6,9;8;1,84;22;5,06
3502606;Aparecida d'Oeste;2014;30;6,95;8;1,85;22;5,1
3502606;Aparecida d'Oeste;2015;21;4,9;20;4,67;1;0,23
3502606;Aparecida d'Oeste;2016;21;4,94;20;4,7;1;0,24
3502606;Aparecida d'Oeste;2017;22;5,21;20;4,74;2;0,47
3502606;Aparecida d'Oeste;2018;22;5,25;20;4,77;2;0,48
3502606;Aparecida d'Oeste;2019;22;5,29;20;4,81;2;0,48
3502705;Apiaí;2010;52;2,06;46;1,82;6;0,24
3502705;Apiaí;2011;47;1,87;41;1,63;6;0,24
3502705;Apiaí;2012;47;1,88;42;1,68;5;0,2
3502705;Apiaí;2013;51;2,05;45;1,81;6;0,24
3502705;Apiaí;2014;51;2,06;45;1,81;6;0,24
3502705;Apiaí;2015;51;2,06;45;1,82;6;0,24
3502705;Apiaí;2016;51;2,07;45;1,82;6;0,24
3502705;Apiaí;2017;51;2,07;45;1,82;6;0,24
3502705;Apiaí;2018;51;2,07;41;1,66;10;0,41
3502705;Apiaí;2019;45;1,82;39;1,58;6;0,24
3503000;Aramina;2010;0;0;0;0;0;0
3503000;Aramina;2011;0;0;0;0;0;0
3503000;Aramina;2012;0;0;0;0;0;0
3503000;Aramina;2013;0;0;0;0;0;0
3503000;Aramina;2014;0;0;0;0;0;0
3503000;Aramina;2015;0;0;0;0;0;0
3503000;Aramina;2016;0;0;0;0;0;0
3503000;Aramina;2017;0;0;0;0;0;0
3503000;Aramina;2018;0;0;0;0;0;0
3503000;Aramina;2019;0;0;0;0;0;0
3503109;Arandu;2010;16;2,61;16;2,61;0;0
3503109;Arandu;2011;16;2,61;16;2,61;0;0
3503109;Arandu;2012;16;2,61;16;2,61;0;0
3503109;Arandu;2013;16;2,61;16;2,61;0;0
3503109;Arandu;2014;16;2,61;16;2,61;0;0
3503109;Arandu;2015;16;2,61;16;2,61;0;0
3503109;Arandu;2016;16;2,6;16;2,6;0;0
3503109;Arandu;2017;16;2,6;16;2,6;0;0
3503109;Arandu;2018;16;2,6;16;2,6;0;0
3503109;Arandu;2019;12;1,95;12;1,95;0;0
3503158;Arapeí;2010;0;0;0;0;0;0
3503158;Arapeí;2011;0;0;0;0;0;0
3503158;Arapeí;2012;0;0;0;0;0;0
3503158;Arapeí;2013;0;0;0;0;0;0
3503158;Arapeí;2014;0;0;0;0;0;0
3503158;Arapeí;2015;0;0;0;0;0;0
3503158;Arapeí;2016;0;0;0;0;0;0
3503158;Arapeí;2017;0;0;0;0;0;0
3503158;Arapeí;2018;0;0;0;0;0;0
3503158;Arapeí;2019;0;0;0;0;0;0
3503208;Araraquara;2010;504;2,42;238;1,14;266;1,28
3503208;Araraquara;2011;545;2,59;238;1,13;307;1,46
3503208;Araraquara;2012;587;2,76;278;1,31;309;1,45
3503208;Araraquara;2013;586;2,72;268;1,25;318;1,48
3503208;Araraquara;2014;576;2,65;262;1,21;314;1,44
3503208;Araraquara;2015;510;2,32;199;0,91;311;1,42
3503208;Araraquara;2016;509;2,3;188;0,85;321;1,45
3503208;Araraquara;2017;443;1,99;216;0,97;227;1,02
3503208;Araraquara;2018;443;1,97;216;0,96;227;1,01
3503208;Araraquara;2019;442;1,96;222;0,98;220;0,97
3503307;Araras;2010;1137;9,58;539;4,54;598;5,04
3503307;Araras;2011;1144;9,53;696;5,8;448;3,73
3503307;Araras;2012;578;4,77;289;2,38;289;2,38
3503307;Araras;2013;557;4,54;289;2,36;268;2,19
3503307;Araras;2014;565;4,56;307;2,48;258;2,08
3503307;Araras;2015;567;4,53;307;2,45;260;2,08
3503307;Araras;2016;557;4,41;300;2,37;257;2,03
3503307;Araras;2017;557;4,37;300;2,35;257;2,02
3503307;Araras;2018;557;4,33;262;2,04;295;2,29
3503307;Araras;2019;503;3,87;246;1,89;257;1,98
3502754;Araçariguama;2010;4;0,24;0;0;4;0,24
3502754;Araçariguama;2011;4;0,23;0;0;4;0,23
3502754;Araçariguama;2012;4;0,22;0;0;4;0,22
3502754;Araçariguama;2013;4;0,22;0;0;4;0,22
3502754;Araçariguama;2014;4;0,21;0;0;4;0,21
3502754;Araçariguama;2015;0;0;0;0;0;0
3502754;Araçariguama;2016;0;0;0;0;0;0
3502754;Araçariguama;2017;0;0;0;0;0;0
3502754;Araçariguama;2018;0;0;0;0;0;0
3502754;Araçariguama;2019;0;0;0;0;0;0
3502804;Araçatuba;2010;660;3,64;495;2,73;165;0,91
3502804;Araçatuba;2011;660;3,62;495;2,71;165;0,9
3502804;Araçatuba;2012;660;3,6;495;2,7;165;0,9
3502804;Araçatuba;2013;625;3,39;477;2,59;148;0,8
3502804;Araçatuba;2014;616;3,32;478;2,58;138;0,74
3502804;Araçatuba;2015;635;3,4;478;2,56;157;0,84
3502804;Araçatuba;2016;474;2,53;328;1,75;146;0,78
3502804;Araçatuba;2017;479;2,55;333;1,77;146;0,78
3502804;Araçatuba;2018;367;1,94;305;1,61;62;0,33
3502804;Araçatuba;2019;435;2,29;305;1,61;130;0,69
3502903;Araçoiaba da Serra;2010;0;0;0;0;0;0
3502903;Araçoiaba da Serra;2011;0;0;0;0;0;0
3502903;Araçoiaba da Serra;2012;90;3,18;0;0;90;3,18
3502903;Araçoiaba da Serra;2013;90;3,12;0;0;90;3,12
3502903;Araçoiaba da Serra;2014;126;4,29;0;0;126;4,29
3502903;Araçoiaba da Serra;2015;288;9,63;0;0;288;9,63
3502903;Araçoiaba da Serra;2016;351;11,55;0;0;351;11,55
3502903;Araçoiaba da Serra;2017;411;13,31;0;0;411;13,31
3502903;Araçoiaba da Serra;2018;321;10,23;0;0;321;10,23
3502903;Araçoiaba da Serra;2019;321;10,07;0;0;321;10,07
3503356;Arco-Íris;2010;0;0;0;0;0;0
3503356;Arco-Íris;2011;0;0;0;0;0;0
3503356;Arco-Íris;2012;0;0;0;0;0;0
3503356;Arco-Íris;2013;0;0;0;0;0;0
3503356;Arco-Íris;2014;0;0;0;0;0;0
3503356;Arco-Íris;2015;0;0;0;0;0;0
3503356;Arco-Íris;2016;0;0;0;0;0;0
3503356;Arco-Íris;2017;0;0;0;0;0;0
3503356;Arco-Íris;2018;0;0;0;0;0;0
3503356;Arco-Íris;2019;0;0;0;0;0;0
3503406;Arealva;2010;24;3,06;22;2,81;2;0,26
3503406;Arealva;2011;24;3,05;22;2,79;2;0,25
3503406;Arealva;2012;24;3,03;22;2,78;2;0,25
3503406;Arealva;2013;28;3,52;17;2,14;11;1,38
3503406;Arealva;2014;28;3,51;17;2,13;11;1,38
3503406;Arealva;2015;28;3,49;17;2,12;11;1,37
3503406;Arealva;2016;28;3,47;17;2,11;11;1,36
3503406;Arealva;2017;28;3,46;17;2,1;11;1,36
3503406;Arealva;2018;29;3,57;18;2,21;11;1,35
3503406;Arealva;2019;29;3,55;18;2,21;11;1,35
3503505;Areias;2010;0;0;0;0;0;0
3503505;Areias;2011;0;0;0;0;0;0
3503505;Areias;2012;0;0;0;0;0;0
3503505;Areias;2013;0;0;0;0;0;0
3503505;Areias;2014;0;0;0;0;0;0
3503505;Areias;2015;0;0;0;0;0;0
3503505;Areias;2016;0;0;0;0;0;0
3503505;Areias;2017;0;0;0;0;0;0
3503505;Areias;2018;0;0;0;0;0;0
3503505;Areias;2019;0;0;0;0;0;0
3503604;Areiópolis;2010;0;0;0;0;0;0
3503604;Areiópolis;2011;0;0;0;0;0;0
3503604;Areiópolis;2012;0;0;0;0;0;0
3503604;Areiópolis;2013;0;0;0;0;0;0
3503604;Areiópolis;2014;0;0;0;0;0;0
3503604;Areiópolis;2015;0;0;0;0;0;0
3503604;Areiópolis;2016;0;0;0;0;0;0
3503604;Areiópolis;2017;0;0;0;0;0;0
3503604;Areiópolis;2018;0;0;0;0;0;0
3503604;Areiópolis;2019;0;0;0;0;0;0
3503703;Ariranha;2010;25;2,93;4;0,47;21;2,46
3503703;Ariranha;2011;25;2,9;4;0,46;21;2,44
3503703;Ariranha;2012;25;2,87;4;0,46;21;2,41
3503703;Ariranha;2013;25;2,85;4;0,46;21;2,39
3503703;Ariranha;2014;25;2,82;4;0,45;21;2,37
3503703;Ariranha;2015;25;2,79;4;0,45;21;2,35
3503703;Ariranha;2016;25;2,77;4;0,44;21;2,33
3503703;Ariranha;2017;25;2,75;4;0,44;21;2,31
3503703;Ariranha;2018;25;2,73;4;0,44;21;2,29
3503703;Ariranha;2019;0;0;0;0;0;0
3503802;Artur Nogueira;2010;56;1,27;0;0;56;1,27
3503802;Artur Nogueira;2011;56;1,24;0;0;56;1,24
3503802;Artur Nogueira;2012;12;0,26;0;0;12;0,26
3503802;Artur Nogueira;2013;12;0,26;0;0;12;0,26
3503802;Artur Nogueira;2014;12;0,25;0;0;12;0,25
3503802;Artur Nogueira;2015;12;0,25;0;0;12;0,25
3503802;Artur Nogueira;2016;12;0,24;0;0;12;0,24
3503802;Artur Nogueira;2017;24;0,48;0;0;24;0,48
3503802;Artur Nogueira;2018;36;0,7;0;0;36;0,7
3503802;Artur Nogueira;2019;36;0,69;0;0;36;0,69
3503901;Arujá;2010;76;1,02;9;0,12;67;0,9
3503901;Arujá;2011;82;1,08;15;0,2;67;0,88
3503901;Arujá;2012;82;1,05;15;0,19;67;0,86
3503901;Arujá;2013;82;1,03;15;0,19;67;0,85
3503901;Arujá;2014;82;1,01;15;0,19;67;0,83
3503901;Arujá;2015;82;0,99;15;0,18;67;0,81
3503901;Arujá;2016;92;1,1;24;0,29;68;0,81
3503901;Arujá;2017;92;1,08;24;0,28;68;0,8
3503901;Arujá;2018;92;1,06;24;0,28;68;0,78
3503901;Arujá;2019;92;1,04;24;0,27;68;0,77
3503950;Aspásia;2010;0;0;0;0;0;0
3503950;Aspásia;2011;0;0;0;0;0;0
3503950;Aspásia;2012;0;0;0;0;0;0
3503950;Aspásia;2013;0;0;0;0;0;0
3503950;Aspásia;2014;0;0;0;0;0;0
3503950;Aspásia;2015;0;0;0;0;0;0
3503950;Aspásia;2016;0;0;0;0;0;0
3503950;Aspásia;2017;0;0;0;0;0;0
3503950;Aspásia;2018;0;0;0;0;0;0
3503950;Aspásia;2019;0;0;0;0;0;0
3504008;Assis;2010;346;3,64;181;1,9;165;1,74
3504008;Assis;2011;342;3,57;176;1,84;166;1,73
3504008;Assis;2012;389;4,04;245;2,54;144;1,49
3504008;Assis;2013;311;3,2;199;2,05;112;1,15
3504008;Assis;2014;314;3,21;195;2;119;1,22
3504008;Assis;2015;290;2,95;179;1,82;111;1,13
3504008;Assis;2016;307;3,1;183;1,85;124;1,25
3504008;Assis;2017;280;2,81;159;1,6;121;1,21
3504008;Assis;2018;285;2,84;160;1,6;125;1,25
3504008;Assis;2019;285;2,83;160;1,59;125;1,24
3504107;Atibaia;2010;187;1,48;48;0,38;139;1,1
3504107;Atibaia;2011;187;1,46;48;0,38;139;1,09
3504107;Atibaia;2012;187;1,45;48;0,37;139;1,08
3504107;Atibaia;2013;187;1,43;50;0,38;137;1,05
3504107;Atibaia;2014;300;2,27;55;0,42;245;1,86
3504107;Atibaia;2015;192;1,44;55;0,41;137;1,03
3504107;Atibaia;2016;192;1,43;55;0,41;137;1,02
3504107;Atibaia;2017;192;1,41;55;0,4;137;1,01
3504107;Atibaia;2018;192;1,4;55;0,4;137;1
3504107;Atibaia;2019;192;1,39;55;0,4;137;0,99
3504206;Auriflama;2010;51;3,59;30;2,11;21;1,48
3504206;Auriflama;2011;51;3,58;30;2,11;21;1,48
3504206;Auriflama;2012;51;3,58;30;2,1;21;1,47
3504206;Auriflama;2013;51;3,57;30;2,1;21;1,47
3504206;Auriflama;2014;51;3,56;30;2,09;21;1,47
3504206;Auriflama;2015;51;3,55;30;2,09;21;1,46
3504206;Auriflama;2016;51;3,54;30;2,09;21;1,46
3504206;Auriflama;2017;44;3,05;35;2,43;9;0,62
3504206;Auriflama;2018;44;3,05;35;2,43;9;0,62
3504206;Auriflama;2019;44;3,04;35;2,42;9;0,62
3504305;Avaí;2010;0;0;0;0;0;0
3504305;Avaí;2011;0;0;0;0;0;0
3504305;Avaí;2012;0;0;0;0;0;0
3504305;Avaí;2013;0;0;0;0;0;0
3504305;Avaí;2014;0;0;0;0;0;0
3504305;Avaí;2015;0;0;0;0;0;0
3504305;Avaí;2016;0;0;0;0;0;0
3504305;Avaí;2017;0;0;0;0;0;0
3504305;Avaí;2018;0;0;0;0;0;0
3504305;Avaí;2019;0;0;0;0;0;0
3504404;Avanhandava;2010;0;0;0;0;0;0
3504404;Avanhandava;2011;0;0;0;0;0;0
3504404;Avanhandava;2012;0;0;0;0;0;0
3504404;Avanhandava;2013;0;0;0;0;0;0
3504404;Avanhandava;2014;0;0;0;0;0;0
3504404;Avanhandava;2015;0;0;0;0;0;0
3504404;Avanhandava;2016;0;0;0;0;0;0
3504404;Avanhandava;2017;0;0;0;0;0;0
3504404;Avanhandava;2018;0;0;0;0;0;0
3504404;Avanhandava;2019;0;0;0;0;0;0
3504503;Avaré;2010;153;1,85;95;1,15;58;0,7
3504503;Avaré;2011;153;1,84;95;1,14;58;0,7
3504503;Avaré;2012;153;1,82;95;1,13;58;0,69
3504503;Avaré;2013;153;1,81;95;1,13;58;0,69
3504503;Avaré;2014;153;1,8;95;1,12;58;0,68
3504503;Avaré;2015;153;1,79;95;1,11;58;0,68
3504503;Avaré;2016;159;1,85;95;1,11;64;0,75
3504503;Avaré;2017;159;1,84;95;1,1;64;0,74
3504503;Avaré;2018;159;1,83;95;1,1;64;0,74
3504503;Avaré;2019;159;1,83;95;1,09;64;0,73
3504602;Bady Bassitt;2010;0;0;0;0;0;0
3504602;Bady Bassitt;2011;0;0;0;0;0;0
3504602;Bady Bassitt;2012;0;0;0;0;0;0
3504602;Bady Bassitt;2013;0;0;0;0;0;0
3504602;Bady Bassitt;2014;0;0;0;0;0;0
3504602;Bady Bassitt;2015;0;0;0;0;0;0
3504602;Bady Bassitt;2016;0;0;0;0;0;0
3504602;Bady Bassitt;2017;0;0;0;0;0;0
3504602;Bady Bassitt;2018;0;0;0;0;0;0
3504602;Bady Bassitt;2019;0;0;0;0;0;0
3504701;Balbinos;2010;0;0;0;0;0;0
3504701;Balbinos;2011;0;0;0;0;0;0
3504701;Balbinos;2012;0;0;0;0;0;0
3504701;Balbinos;2013;0;0;0;0;0;0
3504701;Balbinos;2014;0;0;0;0;0;0
3504701;Balbinos;2015;0;0;0;0;0;0
3504701;Balbinos;2016;0;0;0;0;0;0
3504701;Balbinos;2017;0;0;0;0;0;0
3504701;Balbinos;2018;0;0;0;0;0;0
3504701;Balbinos;2019;0;0;0;0;0;0
3504800;Bálsamo;2010;0;0;0;0;0;0
3504800;Bálsamo;2011;0;0;0;0;0;0
3504800;Bálsamo;2012;0;0;0;0;0;0
3504800;Bálsamo;2013;0;0;0;0;0;0
3504800;Bálsamo;2014;0;0;0;0;0;0
3504800;Bálsamo;2015;0;0;0;0;0;0
3504800;Bálsamo;2016;0;0;0;0;0;0
3504800;Bálsamo;2017;0;0;0;0;0;0
3504800;Bálsamo;2018;0;0;0;0;0;0
3504800;Bálsamo;2019;0;0;0;0;0;0
3504909;Bananal;2010;15;1,47;15;1,47;0;0
3504909;Bananal;2011;15;1,46;15;1,46;0;0
3504909;Bananal;2012;15;1,46;15;1,46;0;0
3504909;Bananal;2013;15;1,45;15;1,45;0;0
3504909;Bananal;2014;15;1,44;15;1,44;0;0
3504909;Bananal;2015;15;1,44;15;1,44;0;0
3504909;Bananal;2016;15;1,43;15;1,43;0;0
3504909;Bananal;2017;15;1,43;15;1,43;0;0
3504909;Bananal;2018;15;1,42;15;1,42;0;0
3504909;Bananal;2019;15;1,41;15;1,41;0;0
3505005;Barão de Antonina;2010;0;0;0;0;0;0
3505005;Barão de Antonina;2011;0;0;0;0;0;0
3505005;Barão de Antonina;2012;0;0;0;0;0;0
3505005;Barão de Antonina;2013;0;0;0;0;0;0
3505005;Barão de Antonina;2014;0;0;0;0;0;0
3505005;Barão de Antonina;2015;0;0;0;0;0;0
3505005;Barão de Antonina;2016;0;0;0;0;0;0
3505005;Barão de Antonina;2017;0;0;0;0;0;0
3505005;Barão de Antonina;2018;0;0;0;0;0;0
3505005;Barão de Antonina;2019;0;0;0;0;0;0
3505104;Barbosa;2010;0;0;0;0;0;0
3505104;Barbosa;2011;0;0;0;0;0;0
3505104;Barbosa;2012;0;0;0;0;0;0
3505104;Barbosa;2013;0;0;0;0;0;0
3505104;Barbosa;2014;0;0;0;0;0;0
3505104;Barbosa;2015;0;0;0;0;0;0
3505104;Barbosa;2016;0;0;0;0;0;0
3505104;Barbosa;2017;0;0;0;0;0;0
3505104;Barbosa;2018;0;0;0;0;0;0
3505104;Barbosa;2019;0;0;0;0;0;0
3505203;Bariri;2010;68;2,15;52;1,65;16;0,51
3505203;Bariri;2011;68;2,14;52;1,63;16;0,5
3505203;Bariri;2012;68;2,12;52;1,62;16;0,5
3505203;Bariri;2013;68;2,1;52;1,61;16;0,49
3505203;Bariri;2014;68;2,09;52;1,59;16;0,49
3505203;Bariri;2015;68;2,07;52;1,58;16;0,49
3505203;Bariri;2016;68;2,05;52;1,57;16;0,48
3505203;Bariri;2017;51;1,53;34;1,02;17;0,51
3505203;Bariri;2018;23;0,69;16;0,48;7;0,21
3505203;Bariri;2019;51;1,51;34;1,01;17;0,5
3505302;Barra Bonita;2010;101;2,87;68;1,93;33;0,94
3505302;Barra Bonita;2011;101;2,87;68;1,93;33;0,94
3505302;Barra Bonita;2012;101;2,87;68;1,93;33;0,94
3505302;Barra Bonita;2013;101;2,87;68;1,94;33;0,94
3505302;Barra Bonita;2014;101;2,88;68;1,94;33;0,94
3505302;Barra Bonita;2015;101;2,88;68;1,94;33;0,94
3505302;Barra Bonita;2016;101;2,88;68;1,94;33;0,94
3505302;Barra Bonita;2017;101;2,89;68;1,94;33;0,94
3505302;Barra Bonita;2018;91;2,6;59;1,69;32;0,92
3505302;Barra Bonita;2019;91;2,6;59;1,69;32;0,92
3505351;Barra do Chapéu;2010;0;0;0;0;0;0
3505351;Barra do Chapéu;2011;0;0;0;0;0;0
3505351;Barra do Chapéu;2012;0;0;0;0;0;0
3505351;Barra do Chapéu;2013;0;0;0;0;0;0
3505351;Barra do Chapéu;2014;0;0;0;0;0;0
3505351;Barra do Chapéu;2015;0;0;0;0;0;0
3505351;Barra do Chapéu;2016;0;0;0;0;0;0
3505351;Barra do Chapéu;2017;0;0;0;0;0;0
3505351;Barra do Chapéu;2018;0;0;0;0;0;0
3505351;Barra do Chapéu;2019;0;0;0;0;0;0
3505401;Barra do Turvo;2010;0;0;0;0;0;0
3505401;Barra do Turvo;2011;0;0;0;0;0;0
3505401;Barra do Turvo;2012;0;0;0;0;0;0
3505401;Barra do Turvo;2013;0;0;0;0;0;0
3505401;Barra do Turvo;2014;0;0;0;0;0;0
3505401;Barra do Turvo;2015;0;0;0;0;0;0
3505401;Barra do Turvo;2016;0;0;0;0;0;0
3505401;Barra do Turvo;2017;0;0;0;0;0;0
3505401;Barra do Turvo;2018;0;0;0;0;0;0
3505401;Barra do Turvo;2019;0;0;0;0;0;0
3505500;Barretos;2010;577;5,15;457;4,08;120;1,07
3505500;Barretos;2011;577;5,12;462;4,1;115;1,02
3505500;Barretos;2012;607;5,35;492;4,34;115;1,01
3505500;Barretos;2013;642;5,63;527;4,62;115;1,01
3505500;Barretos;2014;604;5,27;501;4,37;103;0,9
3505500;Barretos;2015;604;5,23;501;4,34;103;0,89
3505500;Barretos;2016;581;5,01;464;4;117;1,01
3505500;Barretos;2017;513;4,41;425;3,65;88;0,76
3505500;Barretos;2018;504;4,31;391;3,34;113;0,97
3505500;Barretos;2019;504;4,29;391;3,33;113;0,96
3505609;Barrinha;2010;29;1,02;29;1,02;0;0
3505609;Barrinha;2011;29;1,01;29;1,01;0;0
3505609;Barrinha;2012;29;0,99;29;0,99;0;0
3505609;Barrinha;2013;29;0,98;29;0,98;0;0
3505609;Barrinha;2014;0;0;0;0;0;0
3505609;Barrinha;2015;0;0;0;0;0;0
3505609;Barrinha;2016;0;0;0;0;0;0
3505609;Barrinha;2017;0;0;0;0;0;0
3505609;Barrinha;2018;0;0;0;0;0;0
3505609;Barrinha;2019;0;0;0;0;0;0
3505708;Barueri;2010;465;1,93;382;1,59;83;0,35
3505708;Barueri;2011;478;1,97;382;1,57;96;0,4
3505708;Barueri;2012;477;1,94;381;1,55;96;0,39
3505708;Barueri;2013;477;1,92;381;1,54;96;0,39
3505708;Barueri;2014;497;1,98;401;1,6;96;0,38
3505708;Barueri;2015;519;2,05;371;1,47;148;0,58
3505708;Barueri;2016;499;1,95;351;1,37;148;0,58
3505708;Barueri;2017;499;1,94;351;1,36;148;0,57
3505708;Barueri;2018;429;1,65;353;1,36;76;0,29
3505708;Barueri;2019;431;1,64;355;1,35;76;0,29
3505807;Bastos;2010;61;2,98;57;2,79;4;0,2
3505807;Bastos;2011;35;1,71;28;1,37;7;0,34
3505807;Bastos;2012;35;1,72;28;1,37;7;0,34
3505807;Bastos;2013;35;1,72;28;1,38;7;0,34
3505807;Bastos;2014;35;1,72;28;1,38;7;0,34
3505807;Bastos;2015;35;1,73;28;1,38;7;0,35
3505807;Bastos;2016;35;1,73;28;1,38;7;0,35
3505807;Bastos;2017;35;1,73;28;1,38;7;0,35
3505807;Bastos;2018;35;1,73;28;1,38;7;0,35
3505807;Bastos;2019;35;1,72;28;1,38;7;0,34
3505906;Batatais;2010;139;2,46;90;1,59;49;0,87
3505906;Batatais;2011;139;2,45;90;1,58;49;0,86
3505906;Batatais;2012;139;2,43;94;1,64;45;0,79
3505906;Batatais;2013;139;2,41;94;1,63;45;0,78
3505906;Batatais;2014;139;2,39;94;1,62;45;0,78
3505906;Batatais;2015;139;2,38;94;1,61;45;0,77
3505906;Batatais;2016;139;2,36;94;1,6;45;0,77
3505906;Batatais;2017;133;2,25;101;1,71;32;0,54
3505906;Batatais;2018;133;2,23;101;1,7;32;0,54
3505906;Batatais;2019;133;2,22;101;1,69;32;0,53
3506003;Bauru;2010;1148;3,34;802;2,33;346;1,01
3506003;Bauru;2011;1191;3,44;807;2,33;384;1,11
3506003;Bauru;2012;1128;3,24;711;2,04;417;1,2
3506003;Bauru;2013;1144;3,26;697;1,99;447;1,28
3506003;Bauru;2014;1128;3,2;723;2,05;405;1,15
3506003;Bauru;2015;1008;2,84;638;1,8;370;1,04
3506003;Bauru;2016;1107;3,1;612;1,72;495;1,39
3506003;Bauru;2017;1161;3,24;612;1,71;549;1,53
3506003;Bauru;2018;1159;3,22;612;1,7;547;1,52
3506003;Bauru;2019;1228;3,39;636;1,76;592;1,63
3506102;Bebedouro;2010;123;1,64;75;1;48;0,64
3506102;Bebedouro;2011;140;1,87;92;1,23;48;0,64
3506102;Bebedouro;2012;155;2,07;107;1,43;48;0,64
3506102;Bebedouro;2013;157;2,1;111;1,48;46;0,61
3506102;Bebedouro;2014;129;1,73;81;1,08;48;0,64
3506102;Bebedouro;2015;129;1,73;81;1,08;48;0,64
3506102;Bebedouro;2016;129;1,73;81;1,09;48;0,64
3506102;Bebedouro;2017;124;1,66;75;1,01;49;0,66
3506102;Bebedouro;2018;140;1,88;75;1,01;65;0,87
3506102;Bebedouro;2019;140;1,89;75;1,01;65;0,88
3506201;Bento de Abreu;2010;0;0;0;0;0;0
3506201;Bento de Abreu;2011;0;0;0;0;0;0
3506201;Bento de Abreu;2012;0;0;0;0;0;0
3506201;Bento de Abreu;2013;0;0;0;0;0;0
3506201;Bento de Abreu;2014;0;0;0;0;0;0
3506201;Bento de Abreu;2015;0;0;0;0;0;0
3506201;Bento de Abreu;2016;0;0;0;0;0;0
3506201;Bento de Abreu;2017;0;0;0;0;0;0
3506201;Bento de Abreu;2018;0;0;0;0;0;0
3506201;Bento de Abreu;2019;0;0;0;0;0;0
3506300;Bernardino de Campos;2010;50;4,64;16;1,48;34;3,16
3506300;Bernardino de Campos;2011;50;4,64;16;1,49;34;3,16
3506300;Bernardino de Campos;2012;50;4,64;16;1,49;34;3,16
3506300;Bernardino de Campos;2013;50;4,64;20;1,86;30;2,78
3506300;Bernardino de Campos;2014;50;4,64;20;1,86;30;2,79
3506300;Bernardino de Campos;2015;50;4,64;20;1,86;30;2,79
3506300;Bernardino de Campos;2016;50;4,64;20;1,86;30;2,78
3506300;Bernardino de Campos;2017;23;2,13;20;1,86;3;0,28
3506300;Bernardino de Campos;2018;23;2,13;23;2,13;0;0
3506300;Bernardino de Campos;2019;23;2,13;23;2,13;0;0
3506359;Bertioga;2010;51;1,07;51;1,07;0;0
3506359;Bertioga;2011;51;1,04;51;1,04;0;0
3506359;Bertioga;2012;50;0,99;50;0,99;0;0
3506359;Bertioga;2013;46;0,88;46;0,88;0;0
3506359;Bertioga;2014;46;0,85;46;0,85;0;0
3506359;Bertioga;2015;49;0,88;49;0,88;0;0
3506359;Bertioga;2016;49;0,86;49;0,86;0;0
3506359;Bertioga;2017;49;0,84;49;0,84;0;0
3506359;Bertioga;2018;49;0,82;49;0,82;0;0
3506359;Bertioga;2019;49;0,79;49;0,79;0;0
3506409;Bilac;2010;30;4,26;12;1,7;18;2,56
3506409;Bilac;2011;35;4,91;14;1,97;21;2,95
3506409;Bilac;2012;35;4,86;14;1,94;21;2,91
3506409;Bilac;2013;36;4,94;36;4,94;0;0
3506409;Bilac;2014;36;4,88;36;4,88;0;0
3506409;Bilac;2015;36;4,82;36;4,82;0;0
3506409;Bilac;2016;36;4,78;36;4,78;0;0
3506409;Bilac;2017;36;4,73;36;4,73;0;0
3506409;Bilac;2018;36;4,69;36;4,69;0;0
3506409;Bilac;2019;36;4,65;35;4,52;1;0,13
3506508;Birigui;2010;251;2,31;170;1,57;81;0,75
3506508;Birigui;2011;262;2,38;170;1,55;92;0,84
3506508;Birigui;2012;262;2,35;170;1,53;92;0,83
3506508;Birigui;2013;242;2,15;155;1,38;87;0,77
3506508;Birigui;2014;242;2,12;155;1,36;87;0,76
3506508;Birigui;2015;146;1,26;66;0,57;80;0,69
3506508;Birigui;2016;146;1,25;66;0,57;80;0,69
3506508;Birigui;2017;168;1,43;88;0,75;80;0,68
3506508;Birigui;2018;168;1,41;88;0,74;80;0,67
3506508;Birigui;2019;146;1,22;66;0,55;80;0,67
3506607;Biritiba Mirim;2010;14;0,49;14;0,49;0;0
3506607;Biritiba Mirim;2011;0;0;0;0;0;0
3506607;Biritiba Mirim;2012;0;0;0;0;0;0
3506607;Biritiba Mirim;2013;0;0;0;0;0;0
3506607;Biritiba Mirim;2014;0;0;0;0;0;0
3506607;Biritiba Mirim;2015;0;0;0;0;0;0
3506607;Biritiba Mirim;2016;0;0;0;0;0;0
3506607;Biritiba Mirim;2017;0;0;0;0;0;0
3506607;Biritiba Mirim;2018;0;0;0;0;0;0
3506607;Biritiba Mirim;2019;0;0;0;0;0;0
3506706;Boa Esperança do Sul;2010;15;1,1;13;0,95;2;0,15
3506706;Boa Esperança do Sul;2011;15;1,09;13;0,95;2;0,15
3506706;Boa Esperança do Sul;2012;15;1,08;13;0,94;2;0,14
3506706;Boa Esperança do Sul;2013;15;1,08;13;0,93;2;0,14
3506706;Boa Esperança do Sul;2014;15;1,07;13;0,93;2;0,14
3506706;Boa Esperança do Sul;2015;15;1,06;13;0,92;2;0,14
3506706;Boa Esperança do Sul;2016;15;1,06;13;0,91;2;0,14
3506706;Boa Esperança do Sul;2017;15;1,05;13;0,91;2;0,14
3506706;Boa Esperança do Sul;2018;13;0,9;11;0,76;2;0,14
3506706;Boa Esperança do Sul;2019;14;0,97;13;0,9;1;0,07
3506805;Bocaina;2010;35;3,23;30;2,77;5;0,46
3506805;Bocaina;2011;35;3,19;30;2,73;5;0,46
3506805;Bocaina;2012;35;3,15;30;2,7;5;0,45
3506805;Bocaina;2013;35;3,11;30;2,67;5;0,44
3506805;Bocaina;2014;35;3,07;30;2,63;5;0,44
3506805;Bocaina;2015;35;3,04;30;2,6;5;0,43
3506805;Bocaina;2016;35;3,01;29;2,49;6;0,52
3506805;Bocaina;2017;35;2,97;29;2,46;6;0,51
3506805;Bocaina;2018;35;2,94;29;2,44;6;0,5
3506805;Bocaina;2019;35;2,91;29;2,41;6;0,5
3506904;Bofete;2010;0;0;0;0;0;0
3506904;Bofete;2011;0;0;0;0;0;0
3506904;Bofete;2012;0;0;0;0;0;0
3506904;Bofete;2013;0;0;0;0;0;0
3506904;Bofete;2014;0;0;0;0;0;0
3506904;Bofete;2015;0;0;0;0;0;0
3506904;Bofete;2016;0;0;0;0;0;0
3506904;Bofete;2017;0;0;0;0;0;0
3506904;Bofete;2018;0;0;0;0;0;0
3506904;Bofete;2019;0;0;0;0;0;0
3507001;Boituva;2010;58;1,2;42;0,87;16;0,33
3507001;Boituva;2011;55;1,12;39;0,79;16;0,33
3507001;Boituva;2012;55;1,1;39;0,78;16;0,32
3507001;Boituva;2013;55;1,08;39;0,76;16;0,31
3507001;Boituva;2014;55;1,05;39;0,75;16;0,31
3507001;Boituva;2015;55;1,03;36;0,68;19;0,36
3507001;Boituva;2016;53;0,98;36;0,67;17;0,31
3507001;Boituva;2017;53;0,97;36;0,66;17;0,31
3507001;Boituva;2018;53;0,95;36;0,65;17;0,31
3507001;Boituva;2019;54;0,96;36;0,64;18;0,32
3507100;Bom Jesus dos Perdões;2010;11;0,56;11;0,56;0;0
3507100;Bom Jesus dos Perdões;2011;11;0,55;11;0,55;0;0
3507100;Bom Jesus dos Perdões;2012;11;0,53;11;0,53;0;0
3507100;Bom Jesus dos Perdões;2013;11;0,52;11;0,52;0;0
3507100;Bom Jesus dos Perdões;2014;11;0,51;11;0,51;0;0
3507100;Bom Jesus dos Perdões;2015;11;0,5;11;0,5;0;0
3507100;Bom Jesus dos Perdões;2016;11;0,49;11;0,49;0;0
3507100;Bom Jesus dos Perdões;2017;11;0,48;11;0,48;0;0
3507100;Bom Jesus dos Perdões;2018;12;0,51;12;0,51;0;0
3507100;Bom Jesus dos Perdões;2019;12;0,5;12;0,5;0;0
3507159;Bom Sucesso de Itararé;2010;0;0;0;0;0;0
3507159;Bom Sucesso de Itararé;2011;0;0;0;0;0;0
3507159;Bom Sucesso de Itararé;2012;0;0;0;0;0;0
3507159;Bom Sucesso de Itararé;2013;0;0;0;0;0;0
3507159;Bom Sucesso de Itararé;2014;0;0;0;0;0;0
3507159;Bom Sucesso de Itararé;2015;0;0;0;0;0;0
3507159;Bom Sucesso de Itararé;2016;0;0;0;0;0;0
3507159;Bom Sucesso de Itararé;2017;0;0;0;0;0;0
3507159;Bom Sucesso de Itararé;2018;0;0;0;0;0;0
3507159;Bom Sucesso de Itararé;2019;0;0;0;0;0;0
3507209;Borá;2010;0;0;0;0;0;0
3507209;Borá;2011;0;0;0;0;0;0
3507209;Borá;2012;0;0;0;0;0;0
3507209;Borá;2013;0;0;0;0;0;0
3507209;Borá;2014;0;0;0;0;0;0
3507209;Borá;2015;0;0;0;0;0;0
3507209;Borá;2016;0;0;0;0;0;0
3507209;Borá;2017;0;0;0;0;0;0
3507209;Borá;2018;0;0;0;0;0;0
3507209;Borá;2019;0;0;0;0;0;0
3507308;Boracéia;2010;0;0;0;0;0;0
3507308;Boracéia;2011;0;0;0;0;0;0
3507308;Boracéia;2012;0;0;0;0;0;0
3507308;Boracéia;2013;0;0;0;0;0;0
3507308;Boracéia;2014;0;0;0;0;0;0
3507308;Boracéia;2015;0;0;0;0;0;0
3507308;Boracéia;2016;0;0;0;0;0;0
3507308;Boracéia;2017;0;0;0;0;0;0
3507308;Boracéia;2018;0;0;0;0;0;0
3507308;Boracéia;2019;0;0;0;0;0;0
3507407;Borborema;2010;26;1,79;16;1,1;10;0,69
3507407;Borborema;2011;26;1,78;16;1,1;10;0,68
3507407;Borborema;2012;26;1,77;16;1,09;10;0,68
3507407;Borborema;2013;26;1,76;16;1,08;10;0,68
3507407;Borborema;2014;27;1,81;17;1,14;10;0,67
3507407;Borborema;2015;26;1,74;16;1,07;10;0,67
3507407;Borborema;2016;26;1,73;16;1,06;10;0,66
3507407;Borborema;2017;26;1,72;16;1,06;10;0,66
3507407;Borborema;2018;26;1,71;16;1,05;10;0,66
3507407;Borborema;2019;26;1,7;16;1,05;10;0,66
3507456;Borebi;2010;0;0;0;0;0;0
3507456;Borebi;2011;0;0;0;0;0;0
3507456;Borebi;2012;0;0;0;0;0;0
3507456;Borebi;2013;0;0;0;0;0;0
3507456;Borebi;2014;0;0;0;0;0;0
3507456;Borebi;2015;0;0;0;0;0;0
3507456;Borebi;2016;0;0;0;0;0;0
3507456;Borebi;2017;0;0;0;0;0;0
3507456;Borebi;2018;0;0;0;0;0;0
3507456;Borebi;2019;0;0;0;0;0;0
3507506;Botucatu;2010;713;5,61;590;4,64;123;0,97
3507506;Botucatu;2011;604;4,69;497;3,86;107;0,83
3507506;Botucatu;2012;604;4,64;497;3,82;107;0,82
3507506;Botucatu;2013;604;4,59;497;3,77;107;0,81
3507506;Botucatu;2014;604;4,53;497;3,73;107;0,8
3507506;Botucatu;2015;742;5,5;542;4,02;200;1,48
3507506;Botucatu;2016;702;5,16;502;3,69;200;1,47
3507506;Botucatu;2017;741;5,4;541;3,94;200;1,46
3507506;Botucatu;2018;741;5,35;541;3,9;200;1,44
3507506;Botucatu;2019;644;4,6;541;3,87;103;0,74
3507605;Bragança Paulista;2010;326;2,22;192;1,31;134;0,91
3507605;Bragança Paulista;2011;326;2,2;192;1,29;134;0,9
3507605;Bragança Paulista;2012;331;2,2;203;1,35;128;0,85
3507605;Bragança Paulista;2013;343;2,25;215;1,41;128;0,84
3507605;Bragança Paulista;2014;333;2,16;230;1,49;103;0,67
3507605;Bragança Paulista;2015;334;2,14;208;1,33;126;0,81
3507605;Bragança Paulista;2016;395;2,5;210;1,33;185;1,17
3507605;Bragança Paulista;2017;454;2,85;210;1,32;244;1,53
3507605;Bragança Paulista;2018;368;2,29;206;1,28;162;1,01
3507605;Bragança Paulista;2019;372;2,29;206;1,27;166;1,02
3507704;Braúna;2010;0;0;0;0;0;0
3507704;Braúna;2011;0;0;0;0;0;0
3507704;Braúna;2012;0;0;0;0;0;0
3507704;Braúna;2013;0;0;0;0;0;0
3507704;Braúna;2014;0;0;0;0;0;0
3507704;Braúna;2015;0;0;0;0;0;0
3507704;Braúna;2016;0;0;0;0;0;0
3507704;Braúna;2017;0;0;0;0;0;0
3507704;Braúna;2018;0;0;0;0;0;0
3507704;Braúna;2019;0;0;0;0;0;0
3507753;Brejo Alegre;2010;0;0;0;0;0;0
3507753;Brejo Alegre;2011;0;0;0;0;0;0
3507753;Brejo Alegre;2012;0;0;0;0;0;0
3507753;Brejo Alegre;2013;0;0;0;0;0;0
3507753;Brejo Alegre;2014;0;0;0;0;0;0
3507753;Brejo Alegre;2015;0;0;0;0;0;0
3507753;Brejo Alegre;2016;0;0;0;0;0;0
3507753;Brejo Alegre;2017;0;0;0;0;0;0
3507753;Brejo Alegre;2018;0;0;0;0;0;0
3507753;Brejo Alegre;2019;0;0;0;0;0;0
3507803;Brodowski;2010;0;0;0;0;0;0
3507803;Brodowski;2011;0;0;0;0;0;0
3507803;Brodowski;2012;0;0;0;0;0;0
3507803;Brodowski;2013;0;0;0;0;0;0
3507803;Brodowski;2014;0;0;0;0;0;0
3507803;Brodowski;2015;0;0;0;0;0;0
3507803;Brodowski;2016;0;0;0;0;0;0
3507803;Brodowski;2017;0;0;0;0;0;0
3507803;Brodowski;2018;0;0;0;0;0;0
3507803;Brodowski;2019;0;0;0;0;0;0
3507902;Brotas;2010;41;1,9;35;1,62;6;0,28
3507902;Brotas;2011;41;1,88;35;1,61;6;0,28
3507902;Brotas;2012;41;1,86;35;1,59;6;0,27
3507902;Brotas;2013;41;1,84;35;1,57;6;0,27
3507902;Brotas;2014;41;1,82;35;1,55;6;0,27
3507902;Brotas;2015;41;1,8;35;1,54;6;0,26
3507902;Brotas;2016;41;1,78;35;1,52;6;0,26
3507902;Brotas;2017;41;1,77;35;1,51;6;0,26
3507902;Brotas;2018;41;1,75;35;1,49;6;0,26
3507902;Brotas;2019;41;1,73;35;1,48;6;0,25
3508009;Buri;2010;0;0;0;0;0;0
3508009;Buri;2011;0;0;0;0;0;0
3508009;Buri;2012;0;0;0;0;0;0
3508009;Buri;2013;0;0;0;0;0;0
3508009;Buri;2014;0;0;0;0;0;0
3508009;Buri;2015;0;0;0;0;0;0
3508009;Buri;2016;0;0;0;0;0;0
3508009;Buri;2017;0;0;0;0;0;0
3508009;Buri;2018;0;0;0;0;0;0
3508009;Buri;2019;0;0;0;0;0;0
3508108;Buritama;2010;36;2,34;22;1,43;14;0,91
3508108;Buritama;2011;42;2,7;22;1,42;20;1,29
3508108;Buritama;2012;42;2,68;22;1,4;20;1,28
3508108;Buritama;2013;42;2,66;22;1,39;20;1,27
3508108;Buritama;2014;42;2,64;22;1,38;20;1,26
3508108;Buritama;2015;42;2,62;22;1,37;20;1,25
3508108;Buritama;2016;42;2,6;22;1,36;20;1,24
3508108;Buritama;2017;42;2,58;22;1,35;20;1,23
3508108;Buritama;2018;42;2,56;22;1,34;20;1,22
3508108;Buritama;2019;42;2,55;22;1,33;20;1,21
3508207;Buritizal;2010;0;0;0;0;0;0
3508207;Buritizal;2011;0;0;0;0;0;0
3508207;Buritizal;2012;0;0;0;0;0;0
3508207;Buritizal;2013;0;0;0;0;0;0
3508207;Buritizal;2014;0;0;0;0;0;0
3508207;Buritizal;2015;0;0;0;0;0;0
3508207;Buritizal;2016;0;0;0;0;0;0
3508207;Buritizal;2017;0;0;0;0;0;0
3508207;Buritizal;2018;0;0;0;0;0;0
3508207;Buritizal;2019;0;0;0;0;0;0
3508306;Cabrália Paulista;2010;0;0;0;0;0;0
3508306;Cabrália Paulista;2011;0;0;0;0;0;0
3508306;Cabrália Paulista;2012;0;0;0;0;0;0
3508306;Cabrália Paulista;2013;0;0;0;0;0;0
3508306;Cabrália Paulista;2014;0;0;0;0;0;0
3508306;Cabrália Paulista;2015;0;0;0;0;0;0
3508306;Cabrália Paulista;2016;0;0;0;0;0;0
3508306;Cabrália Paulista;2017;0;0;0;0;0;0
3508306;Cabrália Paulista;2018;0;0;0;0;0;0
3508306;Cabrália Paulista;2019;0;0;0;0;0;0
3508405;Cabreúva;2010;36;0,87;28;0,67;8;0,19
3508405;Cabreúva;2011;38;0,9;30;0,71;8;0,19
3508405;Cabreúva;2012;36;0,84;28;0,65;8;0,19
3508405;Cabreúva;2013;36;0,82;28;0,64;8;0,18
3508405;Cabreúva;2014;36;0,81;28;0,63;8;0,18
3508405;Cabreúva;2015;13;0,29;9;0,2;4;0,09
3508405;Cabreúva;2016;13;0,28;9;0,19;4;0,09
3508405;Cabreúva;2017;16;0,34;11;0,23;5;0,11
3508405;Cabreúva;2018;15;0,31;10;0,21;5;0,1
3508405;Cabreúva;2019;15;0,31;10;0,21;5;0,1
3508603;Cachoeira Paulista;2010;47;1,56;40;1,33;7;0,23
3508603;Cachoeira Paulista;2011;47;1,55;40;1,32;7;0,23
3508603;Cachoeira Paulista;2012;47;1,54;40;1,31;7;0,23
3508603;Cachoeira Paulista;2013;47;1,53;40;1,3;7;0,23
3508603;Cachoeira Paulista;2014;47;1,52;40;1,29;7;0,23
3508603;Cachoeira Paulista;2015;47;1,51;40;1,28;7;0,22
3508603;Cachoeira Paulista;2016;47;1,5;40;1,27;7;0,22
3508603;Cachoeira Paulista;2017;47;1,49;40;1,26;7;0,22
3508603;Cachoeira Paulista;2018;47;1,48;40;1,26;7;0,22
3508603;Cachoeira Paulista;2019;16;0,5;14;0,44;2;0,06
3508702;Caconde;2010;75;4,05;64;3,45;11;0,59
3508702;Caconde;2011;75;4,04;64;3,45;11;0,59
3508702;Caconde;2012;65;3,5;58;3,12;7;0,38
3508702;Caconde;2013;61;3,27;55;2,95;6;0,32
3508702;Caconde;2014;64;3,43;64;3,43;0;0
3508702;Caconde;2015;62;3,32;62;3,32;0;0
3508702;Caconde;2016;62;3,31;62;3,31;0;0
3508702;Caconde;2017;62;3,31;62;3,31;0;0
3508702;Caconde;2018;62;3,3;62;3,3;0;0
3508702;Caconde;2019;62;3,29;62;3,29;0;0
3508801;Cafelândia;2010;58;3,49;47;2,83;11;0,66
3508801;Cafelândia;2011;58;3,48;47;2,82;11;0,66
3508801;Cafelândia;2012;58;3,47;47;2,81;11;0,66
3508801;Cafelândia;2013;58;3,45;47;2,8;11;0,65
3508801;Cafelândia;2014;58;3,44;47;2,79;11;0,65
3508801;Cafelândia;2015;58;3,42;47;2,77;11;0,65
3508801;Cafelândia;2016;58;3,41;47;2,76;11;0,65
3508801;Cafelândia;2017;58;3,4;47;2,75;11;0,64
3508801;Cafelândia;2018;48;2,8;37;2,16;11;0,64
3508801;Cafelândia;2019;48;2,79;37;2,15;11;0,64
3508900;Caiabu;2010;0;0;0;0;0;0
3508900;Caiabu;2011;0;0;0;0;0;0
3508900;Caiabu;2012;0;0;0;0;0;0
3508900;Caiabu;2013;0;0;0;0;0;0
3508900;Caiabu;2014;0;0;0;0;0;0
3508900;Caiabu;2015;0;0;0;0;0;0
3508900;Caiabu;2016;0;0;0;0;0;0
3508900;Caiabu;2017;0;0;0;0;0;0
3508900;Caiabu;2018;0;0;0;0;0;0
3508900;Caiabu;2019;0;0;0;0;0;0
3509007;Caieiras;2010;91;1,05;29;0,34;62;0,72
3509007;Caieiras;2011;86;0,98;37;0,42;49;0,56
3509007;Caieiras;2012;68;0,76;29;0,33;39;0,44
3509007;Caieiras;2013;68;0,75;29;0,32;39;0,43
3509007;Caieiras;2014;112;1,22;58;0,63;54;0,59
3509007;Caieiras;2015;117;1,25;58;0,62;59;0,63
3509007;Caieiras;2016;117;1,23;58;0,61;59;0,62
3509007;Caieiras;2017;130;1,35;61;0,63;69;0,72
3509007;Caieiras;2018;122;1,25;67;0,69;55;0,56
3509007;Caieiras;2019;110;1,11;65;0,66;45;0,45
3509106;Caiuá;2010;0;0;0;0;0;0
3509106;Caiuá;2011;0;0;0;0;0;0
3509106;Caiuá;2012;0;0;0;0;0;0
3509106;Caiuá;2013;0;0;0;0;0;0
3509106;Caiuá;2014;0;0;0;0;0;0
3509106;Caiuá;2015;0;0;0;0;0;0
3509106;Caiuá;2016;0;0;0;0;0;0
3509106;Caiuá;2017;0;0;0;0;0;0
3509106;Caiuá;2018;0;0;0;0;0;0
3509106;Caiuá;2019;0;0;0;0;0;0
3509205;Cajamar;2010;71;1,11;71;1,11;0;0
3509205;Cajamar;2011;71;1,09;71;1,09;0;0
3509205;Cajamar;2012;171;2,56;71;1,06;100;1,5
3509205;Cajamar;2013;171;2,51;71;1,04;100;1,47
3509205;Cajamar;2014;171;2,46;71;1,02;100;1,44
3509205;Cajamar;2015;171;2,41;71;1;100;1,41
3509205;Cajamar;2016;155;2,14;55;0,76;100;1,38
3509205;Cajamar;2017;155;2,11;55;0,75;100;1,36
3509205;Cajamar;2018;155;2,07;55;0,73;100;1,33
3509205;Cajamar;2019;149;1,95;49;0,64;100;1,31
3509254;Cajati;2010;13;0,46;13;0,46;0;0
3509254;Cajati;2011;13;0,46;13;0,46;0;0
3509254;Cajati;2012;13;0,46;13;0,46;0;0
3509254;Cajati;2013;13;0,46;13;0,46;0;0
3509254;Cajati;2014;13;0,46;13;0,46;0;0
3509254;Cajati;2015;8;0,28;8;0,28;0;0
3509254;Cajati;2016;0;0;0;0;0;0
3509254;Cajati;2017;0;0;0;0;0;0
3509254;Cajati;2018;0;0;0;0;0;0
3509254;Cajati;2019;0;0;0;0;0;0
3509304;Cajobi;2010;32;3,28;26;2,66;6;0,61
3509304;Cajobi;2011;32;3,26;26;2,65;6;0,61
3509304;Cajobi;2012;32;3,25;26;2,64;6;0,61
3509304;Cajobi;2013;32;3,24;26;2,63;6;0,61
3509304;Cajobi;2014;32;3,23;26;2,62;6;0,6
3509304;Cajobi;2015;32;3,21;26;2,61;6;0,6
3509304;Cajobi;2016;32;3,2;26;2,6;6;0,6
3509304;Cajobi;2017;32;3,19;26;2,6;6;0,6
3509304;Cajobi;2018;32;3,19;26;2,59;6;0,6
3509304;Cajobi;2019;32;3,18;26;2,58;6;0,6
3509403;Cajuru;2010;68;2,91;50;2,14;18;0,77
3509403;Cajuru;2011;68;2,88;50;2,12;18;0,76
3509403;Cajuru;2012;68;2,86;50;2,1;18;0,76
3509403;Cajuru;2013;68;2,83;50;2,08;18;0,75
3509403;Cajuru;2014;73;3;55;2,26;18;0,74
3509403;Cajuru;2015;73;2,98;55;2,24;18;0,73
3509403;Cajuru;2016;73;2,95;55;2,22;18;0,73
3509403;Cajuru;2017;140;5,6;55;2,2;85;3,4
3509403;Cajuru;2018;140;5,55;55;2,18;85;3,37
3509403;Cajuru;2019;140;5,5;55;2,16;85;3,34
3509452;Campina do Monte Alegre;2010;0;0;0;0;0;0
3509452;Campina do Monte Alegre;2011;0;0;0;0;0;0
3509452;Campina do Monte Alegre;2012;0;0;0;0;0;0
3509452;Campina do Monte Alegre;2013;0;0;0;0;0;0
3509452;Campina do Monte Alegre;2014;0;0;0;0;0;0
3509452;Campina do Monte Alegre;2015;0;0;0;0;0;0
3509452;Campina do Monte Alegre;2016;0;0;0;0;0;0
3509452;Campina do Monte Alegre;2017;0;0;0;0;0;0
3509452;Campina do Monte Alegre;2018;0;0;0;0;0;0
3509452;Campina do Monte Alegre;2019;0;0;0;0;0;0
3509502;Campinas;2010;2764;2,56;1407;1,3;1357;1,26
3509502;Campinas;2011;2753;2,53;1375;1,26;1378;1,26
3509502;Campinas;2012;2948;2,68;1351;1,23;1597;1,45
3509502;Campinas;2013;2961;2,66;1425;1,28;1536;1,38
3509502;Campinas;2014;2959;2,63;1445;1,29;1514;1,35
3509502;Campinas;2015;2957;2,61;1395;1,23;1562;1,38
3509502;Campinas;2016;2918;2,55;1332;1,17;1586;1,39
3509502;Campinas;2017;2749;2,39;1311;1,14;1438;1,25
3509502;Campinas;2018;2755;2,38;1322;1,14;1433;1,24
3509502;Campinas;2019;2578;2,21;1316;1,13;1262;1,08
3509601;Campo Limpo Paulista;2010;44;0,59;44;0,59;0;0
3509601;Campo Limpo Paulista;2011;44;0,59;44;0,59;0;0
3509601;Campo Limpo Paulista;2012;56;0,74;56;0,74;0;0
3509601;Campo Limpo Paulista;2013;56;0,73;56;0,73;0;0
3509601;Campo Limpo Paulista;2014;56;0,72;56;0,72;0;0
3509601;Campo Limpo Paulista;2015;56;0,71;56;0,71;0;0
3509601;Campo Limpo Paulista;2016;56;0,7;56;0,7;0;0
3509601;Campo Limpo Paulista;2017;68;0,85;68;0,85;0;0
3509601;Campo Limpo Paulista;2018;68;0,84;68;0,84;0;0
3509601;Campo Limpo Paulista;2019;68;0,83;68;0,83;0;0
3509700;Campos do Jordão;2010;444;9,3;322;6,74;122;2,55
3509700;Campos do Jordão;2011;444;9,25;342;7,12;102;2,12
3509700;Campos do Jordão;2012;376;7,79;329;6,82;47;0,97
3509700;Campos do Jordão;2013;376;7,75;329;6,78;47;0,97
3509700;Campos do Jordão;2014;242;4,96;195;4;47;0,96
3509700;Campos do Jordão;2015;242;4,94;195;3,98;47;0,96
3509700;Campos do Jordão;2016;297;6,03;250;5,08;47;0,95
3509700;Campos do Jordão;2017;201;4,07;191;3,86;10;0,2
3509700;Campos do Jordão;2018;201;4,05;191;3,85;10;0,2
3509700;Campos do Jordão;2019;201;4,03;191;3,83;10;0,2
3509809;Campos Novos Paulista;2010;0;0;0;0;0;0
3509809;Campos Novos Paulista;2011;0;0;0;0;0;0
3509809;Campos Novos Paulista;2012;0;0;0;0;0;0
3509809;Campos Novos Paulista;2013;0;0;0;0;0;0
3509809;Campos Novos Paulista;2014;0;0;0;0;0;0
3509809;Campos Novos Paulista;2015;0;0;0;0;0;0
3509809;Campos Novos Paulista;2016;0;0;0;0;0;0
3509809;Campos Novos Paulista;2017;0;0;0;0;0;0
3509809;Campos Novos Paulista;2018;0;0;0;0;0;0
3509809;Campos Novos Paulista;2019;0;0;0;0;0;0
3509908;Cananéia;2010;0;0;0;0;0;0
3509908;Cananéia;2011;0;0;0;0;0;0
3509908;Cananéia;2012;0;0;0;0;0;0
3509908;Cananéia;2013;0;0;0;0;0;0
3509908;Cananéia;2014;0;0;0;0;0;0
3509908;Cananéia;2015;0;0;0;0;0;0
3509908;Cananéia;2016;0;0;0;0;0;0
3509908;Cananéia;2017;0;0;0;0;0;0
3509908;Cananéia;2018;0;0;0;0;0;0
3509908;Cananéia;2019;0;0;0;0;0;0
3509957;Canas;2010;0;0;0;0;0;0
3509957;Canas;2011;0;0;0;0;0;0
3509957;Canas;2012;0;0;0;0;0;0
3509957;Canas;2013;0;0;0;0;0;0
3509957;Canas;2014;0;0;0;0;0;0
3509957;Canas;2015;0;0;0;0;0;0
3509957;Canas;2016;0;0;0;0;0;0
3509957;Canas;2017;0;0;0;0;0;0
3509957;Canas;2018;0;0;0;0;0;0
3509957;Canas;2019;0;0;0;0;0;0
3510005;Cândido Mota;2010;50;1,67;40;1,34;10;0,33
3510005;Cândido Mota;2011;50;1,67;40;1,34;10;0,33
3510005;Cândido Mota;2012;50;1,67;40;1,34;10;0,33
3510005;Cândido Mota;2013;50;1,67;40;1,34;10;0,33
3510005;Cândido Mota;2014;30;1;25;0,83;5;0,17
3510005;Cândido Mota;2015;30;1;25;0,83;5;0,17
3510005;Cândido Mota;2016;30;1;25;0,83;5;0,17
3510005;Cândido Mota;2017;30;1;25;0,83;5;0,17
3510005;Cândido Mota;2018;30;1;25;0,83;5;0,17
3510005;Cândido Mota;2019;30;1;25;0,83;5;0,17
3510104;Cândido Rodrigues;2010;0;0;0;0;0;0
3510104;Cândido Rodrigues;2011;0;0;0;0;0;0
3510104;Cândido Rodrigues;2012;0;0;0;0;0;0
3510104;Cândido Rodrigues;2013;0;0;0;0;0;0
3510104;Cândido Rodrigues;2014;0;0;0;0;0;0
3510104;Cândido Rodrigues;2015;0;0;0;0;0;0
3510104;Cândido Rodrigues;2016;0;0;0;0;0;0
3510104;Cândido Rodrigues;2017;0;0;0;0;0;0
3510104;Cândido Rodrigues;2018;0;0;0;0;0;0
3510104;Cândido Rodrigues;2019;0;0;0;0;0;0
3510153;Canitar;2010;0;0;0;0;0;0
3510153;Canitar;2011;0;0;0;0;0;0
3510153;Canitar;2012;0;0;0;0;0;0
3510153;Canitar;2013;0;0;0;0;0;0
3510153;Canitar;2014;0;0;0;0;0;0
3510153;Canitar;2015;0;0;0;0;0;0
3510153;Canitar;2016;0;0;0;0;0;0
3510153;Canitar;2017;0;0;0;0;0;0
3510153;Canitar;2018;0;0;0;0;0;0
3510153;Canitar;2019;0;0;0;0;0;0
3510203;Capão Bonito;2010;100;2,17;75;1,62;25;0,54
3510203;Capão Bonito;2011;95;2,06;70;1,52;25;0,54
3510203;Capão Bonito;2012;67;1,45;49;1,06;18;0,39
3510203;Capão Bonito;2013;67;1,45;49;1,06;18;0,39
3510203;Capão Bonito;2014;67;1,45;49;1,06;18;0,39
3510203;Capão Bonito;2015;67;1,45;49;1,06;18;0,39
3510203;Capão Bonito;2016;67;1,45;49;1,06;18;0,39
3510203;Capão Bonito;2017;67;1,45;49;1,06;18;0,39
3510203;Capão Bonito;2018;58;1,25;48;1,04;10;0,22
3510203;Capão Bonito;2019;58;1,25;48;1,04;10;0,22
3510302;Capela do Alto;2010;0;0;0;0;0;0
3510302;Capela do Alto;2011;0;0;0;0;0;0
3510302;Capela do Alto;2012;0;0;0;0;0;0
3510302;Capela do Alto;2013;0;0;0;0;0;0
3510302;Capela do Alto;2014;0;0;0;0;0;0
3510302;Capela do Alto;2015;0;0;0;0;0;0
3510302;Capela do Alto;2016;14;0,73;14;0,73;0;0
3510302;Capela do Alto;2017;14;0,71;14;0,71;0;0
3510302;Capela do Alto;2018;14;0,7;14;0,7;0;0
3510302;Capela do Alto;2019;59;2,92;14;0,69;45;2,22
3510401;Capivari;2010;119;2,45;58;1,2;61;1,26
3510401;Capivari;2011;119;2,42;58;1,18;61;1,24
3510401;Capivari;2012;119;2,4;58;1,17;61;1,23
3510401;Capivari;2013;96;1,91;41;0,82;55;1,09
3510401;Capivari;2014;96;1,89;46;0,9;50;0,98
3510401;Capivari;2015;96;1,87;46;0,89;50;0,97
3510401;Capivari;2016;96;1,85;46;0,88;50;0,96
3510401;Capivari;2017;96;1,83;46;0,88;50;0,95
3510401;Capivari;2018;87;1,64;47;0,89;40;0,75
3510401;Capivari;2019;93;1,73;47;0,88;46;0,86
3510500;Caraguatatuba;2010;160;1,59;122;1,21;38;0,38
3510500;Caraguatatuba;2011;158;1,55;120;1,17;38;0,37
3510500;Caraguatatuba;2012;158;1,52;120;1,15;38;0,37
3510500;Caraguatatuba;2013;158;1,5;120;1,14;38;0,36
3510500;Caraguatatuba;2014;158;1,47;120;1,12;38;0,35
3510500;Caraguatatuba;2015;157;1,44;102;0,94;55;0,5
3510500;Caraguatatuba;2016;165;1,49;107;0,97;58;0,53
3510500;Caraguatatuba;2017;165;1,48;107;0,96;58;0,52
3510500;Caraguatatuba;2018;165;1,46;111;0,98;54;0,48
3510500;Caraguatatuba;2019;165;1,44;111;0,97;54;0,47
3510609;Carapicuíba;2010;271;0,73;228;0,62;43;0,12
3510609;Carapicuíba;2011;228;0,61;228;0,61;0;0
3510609;Carapicuíba;2012;353;0,94;263;0,7;90;0,24
3510609;Carapicuíba;2013;353;0,93;263;0,7;90;0,24
3510609;Carapicuíba;2014;353;0,93;263;0,69;90;0,24
3510609;Carapicuíba;2015;370;0,97;280;0,73;90;0,23
3510609;Carapicuíba;2016;370;0,96;220;0,57;150;0,39
3510609;Carapicuíba;2017;270;0,7;220;0,57;50;0,13
3510609;Carapicuíba;2018;270;0,69;220;0,56;50;0,13
3510609;Carapicuíba;2019;270;0,69;220;0,56;50;0,13
3510708;Cardoso;2010;31;2,63;18;1,53;13;1,1
3510708;Cardoso;2011;31;2,63;18;1,53;13;1,1
3510708;Cardoso;2012;31;2,63;18;1,53;13;1,1
3510708;Cardoso;2013;31;2,63;18;1,53;13;1,1
3510708;Cardoso;2014;31;2,63;14;1,19;17;1,44
3510708;Cardoso;2015;31;2,63;14;1,19;17;1,44
3510708;Cardoso;2016;31;2,64;13;1,11;18;1,53
3510708;Cardoso;2017;31;2,64;13;1,11;18;1,53
3510708;Cardoso;2018;31;2,64;12;1,02;19;1,62
3510708;Cardoso;2019;31;2,64;12;1,02;19;1,62
3510807;Casa Branca;2010;457;16,15;440;15,55;17;0,6
3510807;Casa Branca;2011;412;14,5;395;13,9;17;0,6
3510807;Casa Branca;2012;412;14,44;395;13,84;17;0,6
3510807;Casa Branca;2013;412;14,38;395;13,78;17;0,59
3510807;Casa Branca;2014;412;14,32;395;13,73;17;0,59
3510807;Casa Branca;2015;372;12,87;355;12,28;17;0,59
3510807;Casa Branca;2016;372;12,82;355;12,24;17;0,59
3510807;Casa Branca;2017;372;12,77;356;12,22;16;0,55
3510807;Casa Branca;2018;372;12,72;356;12,18;16;0,55
3510807;Casa Branca;2019;372;12,68;356;12,13;16;0,55
3510906;Cássia dos Coqueiros;2010;0;0;0;0;0;0
3510906;Cássia dos Coqueiros;2011;0;0;0;0;0;0
3510906;Cássia dos Coqueiros;2012;0;0;0;0;0;0
3510906;Cássia dos Coqueiros;2013;0;0;0;0;0;0
3510906;Cássia dos Coqueiros;2014;0;0;0;0;0;0
3510906;Cássia dos Coqueiros;2015;0;0;0;0;0;0
3510906;Cássia dos Coqueiros;2016;0;0;0;0;0;0
3510906;Cássia dos Coqueiros;2017;0;0;0;0;0;0
3510906;Cássia dos Coqueiros;2018;0;0;0;0;0;0
3510906;Cássia dos Coqueiros;2019;0;0;0;0;0;0
3511003;Castilho;2010;46;2,56;30;1,67;16;0,89
3511003;Castilho;2011;11;0,6;9;0,49;2;0,11
3511003;Castilho;2012;25;1,35;21;1,13;4;0,22
3511003;Castilho;2013;31;1,65;27;1,43;4;0,21
3511003;Castilho;2014;31;1,62;30;1,57;1;0,05
3511003;Castilho;2015;31;1,6;30;1,55;1;0,05
3511003;Castilho;2016;31;1,58;30;1,53;1;0,05
3511003;Castilho;2017;31;1,56;30;1,51;1;0,05
3511003;Castilho;2018;31;1,54;30;1,49;1;0,05
3511003;Castilho;2019;31;1,52;30;1,47;1;0,05
3511102;Catanduva;2010;575;5,1;425;3,77;150;1,33
3511102;Catanduva;2011;575;5,08;425;3,75;150;1,32
3511102;Catanduva;2012;526;4,62;396;3,48;130;1,14
3511102;Catanduva;2013;513;4,49;373;3,26;140;1,23
3511102;Catanduva;2014;514;4,48;373;3,25;141;1,23
3511102;Catanduva;2015;534;4,63;375;3,25;159;1,38
3511102;Catanduva;2016;535;4,63;374;3,23;161;1,39
3511102;Catanduva;2017;533;4,59;374;3,22;159;1,37
3511102;Catanduva;2018;533;4,58;374;3,21;159;1,37
3511102;Catanduva;2019;588;5,03;374;3,2;214;1,83
3511201;Catiguá;2010;0;0;0;0;0;0
3511201;Catiguá;2011;0;0;0;0;0;0
3511201;Catiguá;2012;0;0;0;0;0;0
3511201;Catiguá;2013;0;0;0;0;0;0
3511201;Catiguá;2014;0;0;0;0;0;0
3511201;Catiguá;2015;0;0;0;0;0;0
3511201;Catiguá;2016;0;0;0;0;0;0
3511201;Catiguá;2017;0;0;0;0;0;0
3511201;Catiguá;2018;0;0;0;0;0;0
3511201;Catiguá;2019;0;0;0;0;0;0
3508504;Caçapava;2010;123;1,45;67;0,79;56;0,66
3508504;Caçapava;2011;132;1,55;63;0,74;69;0,81
3508504;Caçapava;2012;132;1,53;63;0,73;69;0,8
3508504;Caçapava;2013;147;1,69;74;0,85;73;0,84
3508504;Caçapava;2014;145;1,66;77;0,88;68;0,78
3508504;Caçapava;2015;151;1,71;73;0,83;78;0,88
3508504;Caçapava;2016;151;1,7;73;0,82;78;0,88
3508504;Caçapava;2017;139;1,55;63;0,7;76;0,85
3508504;Caçapava;2018;118;1,31;68;0,76;50;0,56
3508504;Caçapava;2019;178;1,96;63;0,7;115;1,27
3511300;Cedral;2010;0;0;0;0;0;0
3511300;Cedral;2011;0;0;0;0;0;0
3511300;Cedral;2012;0;0;0;0;0;0
3511300;Cedral;2013;0;0;0;0;0;0
3511300;Cedral;2014;0;0;0;0;0;0
3511300;Cedral;2015;30;3,56;0;0;30;3,56
3511300;Cedral;2016;30;3,52;0;0;30;3,52
3511300;Cedral;2017;50;5,82;0;0;50;5,82
3511300;Cedral;2018;50;5,77;0;0;50;5,77
3511300;Cedral;2019;50;5,71;0;0;50;5,71
3511409;Cerqueira César;2010;42;2,4;33;1,88;9;0,51
3511409;Cerqueira César;2011;42;2,38;33;1,87;9;0,51
3511409;Cerqueira César;2012;42;2,35;33;1,85;9;0,5
3511409;Cerqueira César;2013;42;2,33;33;1,83;9;0,5
3511409;Cerqueira César;2014;51;2,8;33;1,81;18;0,99
3511409;Cerqueira César;2015;52;2,83;34;1,85;18;0,98
3511409;Cerqueira César;2016;52;2,8;34;1,83;18;0,97
3511409;Cerqueira César;2017;52;2,78;34;1,82;18;0,96
3511409;Cerqueira César;2018;39;2,07;32;1,7;7;0,37
3511409;Cerqueira César;2019;39;2,05;32;1,68;7;0,37
3511508;Cerquilho;2010;39;0,99;31;0,78;8;0,2
3511508;Cerquilho;2011;39;0,97;31;0,77;8;0,2
3511508;Cerquilho;2012;42;1,02;26;0,63;16;0,39
3511508;Cerquilho;2013;43;1,03;33;0,79;10;0,24
3511508;Cerquilho;2014;43;1,01;31;0,73;12;0,28
3511508;Cerquilho;2015;43;0,99;31;0,72;12;0,28
3511508;Cerquilho;2016;37;0,84;29;0,66;8;0,18
3511508;Cerquilho;2017;37;0,83;29;0,65;8;0,18
3511508;Cerquilho;2018;28;0,62;18;0,4;10;0,22
3511508;Cerquilho;2019;32;0,7;21;0,46;11;0,24
3511607;Cesário Lange;2010;30;1,93;17;1,1;13;0,84
3511607;Cesário Lange;2011;30;1,91;17;1,08;13;0,83
3511607;Cesário Lange;2012;30;1,89;17;1,07;13;0,82
3511607;Cesário Lange;2013;30;1,86;17;1,06;13;0,81
3511607;Cesário Lange;2014;30;1,84;17;1,04;13;0,8
3511607;Cesário Lange;2015;30;1,82;17;1,03;13;0,79
3511607;Cesário Lange;2016;30;1,8;17;1,02;13;0,78
3511607;Cesário Lange;2017;30;1,79;17;1,01;13;0,77
3511607;Cesário Lange;2018;30;1,77;17;1;13;0,77
3511607;Cesário Lange;2019;22;1,29;17;0,99;5;0,29
3511706;Charqueada;2010;33;2,19;26;1,73;7;0,46
3511706;Charqueada;2011;33;2,16;26;1,7;7;0,46
3511706;Charqueada;2012;33;2,14;26;1,68;7;0,45
3511706;Charqueada;2013;33;2,11;26;1,66;7;0,45
3511706;Charqueada;2014;33;2,08;26;1,64;7;0,44
3511706;Charqueada;2015;33;2,06;26;1,62;7;0,44
3511706;Charqueada;2016;33;2,03;26;1,6;7;0,43
3511706;Charqueada;2017;33;2,01;26;1,59;7;0,43
3511706;Charqueada;2018;33;1,99;26;1,57;7;0,42
3511706;Charqueada;2019;33;1,97;26;1,55;7;0,42
3557204;Chavantes;2010;48;3,96;20;1,65;28;2,31
3557204;Chavantes;2011;48;3,96;20;1,65;28;2,31
3557204;Chavantes;2012;48;3,96;20;1,65;28;2,31
3557204;Chavantes;2013;48;3,95;27;2,22;21;1,73
3557204;Chavantes;2014;50;4,11;30;2,47;20;1,65
3557204;Chavantes;2015;50;4,11;30;2,47;20;1,64
3557204;Chavantes;2016;50;4,11;30;2,46;20;1,64
3557204;Chavantes;2017;50;4,1;30;2,46;20;1,64
3557204;Chavantes;2018;50;4,1;30;2,46;20;1,64
3557204;Chavantes;2019;50;4,09;30;2,46;20;1,64
3511904;Clementina;2010;30;4,26;20;2,84;10;1,42
3511904;Clementina;2011;30;4,18;20;2,78;10;1,39
3511904;Clementina;2012;30;4,1;20;2,73;10;1,37
3511904;Clementina;2013;30;4,02;20;2,68;10;1,34
3511904;Clementina;2014;30;3,95;20;2,63;10;1,32
3511904;Clementina;2015;30;3,87;20;2,58;10;1,29
3511904;Clementina;2016;30;3,82;20;2,55;10;1,27
3511904;Clementina;2017;30;3,76;20;2,51;10;1,25
3511904;Clementina;2018;30;3,71;20;2,47;10;1,24
3511904;Clementina;2019;30;3,66;20;2,44;10;1,22
3512001;Colina;2010;47;2,71;40;2,3;7;0,4
3512001;Colina;2011;47;2,7;40;2,3;7;0,4
3512001;Colina;2012;47;2,7;40;2,3;7;0,4
3512001;Colina;2013;47;2,69;40;2,29;7;0,4
3512001;Colina;2014;47;2,69;40;2,29;7;0,4
3512001;Colina;2015;47;2,68;35;2;12;0,69
3512001;Colina;2016;47;2,68;35;2;12;0,68
3512001;Colina;2017;47;2,68;35;1,99;12;0,68
3512001;Colina;2018;47;2,68;35;1,99;12;0,68
3512001;Colina;2019;47;2,67;35;1,99;12;0,68
3512100;Colômbia;2010;20;3,34;20;3,34;0;0
3512100;Colômbia;2011;30;5;20;3,33;10;1,67
3512100;Colômbia;2012;30;4,99;20;3,33;10;1,66
3512100;Colômbia;2013;30;4,99;20;3,33;10;1,66
3512100;Colômbia;2014;30;4,98;20;3,32;10;1,66
3512100;Colômbia;2015;30;4,98;20;3,32;10;1,66
3512100;Colômbia;2016;20;3,32;20;3,32;0;0
3512100;Colômbia;2017;20;3,31;20;3,31;0;0
3512100;Colômbia;2018;20;3,31;20;3,31;0;0
3512100;Colômbia;2019;20;3,31;20;3,31;0;0
3512209;Conchal;2010;60;2,38;44;1,75;16;0,63
3512209;Conchal;2011;55;2,16;44;1,73;11;0,43
3512209;Conchal;2012;52;2,03;41;1,6;11;0,43
3512209;Conchal;2013;52;2,01;41;1,59;11;0,43
3512209;Conchal;2014;52;1,99;41;1,57;11;0,42
3512209;Conchal;2015;52;1,98;41;1,56;11;0,42
3512209;Conchal;2016;52;1,96;41;1,55;11;0,42
3512209;Conchal;2017;55;2,06;50;1,87;5;0,19
3512209;Conchal;2018;52;1,93;50;1,86;2;0,07
3512209;Conchal;2019;52;1,92;42;1,55;10;0,37
3512308;Conchas;2010;44;2,7;37;2,27;7;0,43
3512308;Conchas;2011;44;2,69;37;2,26;7;0,43
3512308;Conchas;2012;42;2,55;35;2,13;7;0,43
3512308;Conchas;2013;42;2,54;42;2,54;0;0
3512308;Conchas;2014;42;2,53;42;2,53;0;0
3512308;Conchas;2015;32;1,91;32;1,91;0;0
3512308;Conchas;2016;32;1,9;32;1,9;0;0
3512308;Conchas;2017;32;1,9;32;1,9;0;0
3512308;Conchas;2018;32;1,89;32;1,89;0;0
3512308;Conchas;2019;32;1,88;32;1,88;0;0
3512407;Cordeirópolis;2010;0;0;0;0;0;0
3512407;Cordeirópolis;2011;0;0;0;0;0;0
3512407;Cordeirópolis;2012;0;0;0;0;0;0
3512407;Cordeirópolis;2013;0;0;0;0;0;0
3512407;Cordeirópolis;2014;0;0;0;0;0;0
3512407;Cordeirópolis;2015;0;0;0;0;0;0
3512407;Cordeirópolis;2016;0;0;0;0;0;0
3512407;Cordeirópolis;2017;0;0;0;0;0;0
3512407;Cordeirópolis;2018;0;0;0;0;0;0
3512407;Cordeirópolis;2019;0;0;0;0;0;0
3512506;Coroados;2010;0;0;0;0;0;0
3512506;Coroados;2011;0;0;0;0;0;0
3512506;Coroados;2012;0;0;0;0;0;0
3512506;Coroados;2013;0;0;0;0;0;0
3512506;Coroados;2014;0;0;0;0;0;0
3512506;Coroados;2015;0;0;0;0;0;0
3512506;Coroados;2016;0;0;0;0;0;0
3512506;Coroados;2017;0;0;0;0;0;0
3512506;Coroados;2018;0;0;0;0;0;0
3512506;Coroados;2019;0;0;0;0;0;0
3512605;Coronel Macedo;2010;0;0;0;0;0;0
3512605;Coronel Macedo;2011;0;0;0;0;0;0
3512605;Coronel Macedo;2012;0;0;0;0;0;0
3512605;Coronel Macedo;2013;0;0;0;0;0;0
3512605;Coronel Macedo;2014;0;0;0;0;0;0
3512605;Coronel Macedo;2015;0;0;0;0;0;0
3512605;Coronel Macedo;2016;0;0;0;0;0;0
3512605;Coronel Macedo;2017;6;1,23;6;1,23;0;0
3512605;Coronel Macedo;2018;6;1,23;6;1,23;0;0
3512605;Coronel Macedo;2019;6;1,24;6;1,24;0;0
3512704;Corumbataí;2010;0;0;0;0;0;0
3512704;Corumbataí;2011;0;0;0;0;0;0
3512704;Corumbataí;2012;0;0;0;0;0;0
3512704;Corumbataí;2013;0;0;0;0;0;0
3512704;Corumbataí;2014;0;0;0;0;0;0
3512704;Corumbataí;2015;0;0;0;0;0;0
3512704;Corumbataí;2016;0;0;0;0;0;0
3512704;Corumbataí;2017;0;0;0;0;0;0
3512704;Corumbataí;2018;0;0;0;0;0;0
3512704;Corumbataí;2019;0;0;0;0;0;0
3512803;Cosmópolis;2010;90;1,53;61;1,04;29;0,49
3512803;Cosmópolis;2011;90;1,5;61;1,02;29;0,48
3512803;Cosmópolis;2012;103;1,68;74;1,21;29;0,47
3512803;Cosmópolis;2013;103;1,65;74;1,18;29;0,46
3512803;Cosmópolis;2014;90;1,41;63;0,99;27;0,42
3512803;Cosmópolis;2015;90;1,38;63;0,96;27;0,41
3512803;Cosmópolis;2016;90;1,35;63;0,95;27;0,41
3512803;Cosmópolis;2017;90;1,33;0;0;90;1,33
3512803;Cosmópolis;2018;112;1,63;60;0,87;52;0,76
3512803;Cosmópolis;2019;68;0,97;33;0,47;35;0,5
3512902;Cosmorama;2010;0;0;0;0;0;0
3512902;Cosmorama;2011;0;0;0;0;0;0
3512902;Cosmorama;2012;0;0;0;0;0;0
3512902;Cosmorama;2013;0;0;0;0;0;0
3512902;Cosmorama;2014;0;0;0;0;0;0
3512902;Cosmorama;2015;0;0;0;0;0;0
3512902;Cosmorama;2016;0;0;0;0;0;0
3512902;Cosmorama;2017;0;0;0;0;0;0
3512902;Cosmorama;2018;0;0;0;0;0;0
3512902;Cosmorama;2019;0;0;0;0;0;0
3513009;Cotia;2010;240;1,2;176;0,88;64;0,32
3513009;Cotia;2011;253;1,23;189;0,92;64;0,31
3513009;Cotia;2012;287;1,37;189;0,9;98;0,47
3513009;Cotia;2013;287;1,34;189;0,88;98;0,46
3513009;Cotia;2014;287;1,31;109;0,5;178;0,81
3513009;Cotia;2015;289;1,28;111;0,49;178;0,79
3513009;Cotia;2016;177;0,77;111;0,48;66;0,29
3513009;Cotia;2017;503;2,15;111;0,47;392;1,68
3513009;Cotia;2018;553;2,32;111;0,47;442;1,86
3513009;Cotia;2019;667;2,75;111;0,46;556;2,29
3513108;Cravinhos;2010;23;0,73;23;0,73;0;0
3513108;Cravinhos;2011;23;0,72;23;0,72;0;0
3513108;Cravinhos;2012;15;0,47;13;0,4;2;0,06
3513108;Cravinhos;2013;15;0,46;13;0,4;2;0,06
3513108;Cravinhos;2014;15;0,46;13;0,4;2;0,06
3513108;Cravinhos;2015;15;0,45;13;0,39;2;0,06
3513108;Cravinhos;2016;15;0,45;13;0,39;2;0,06
3513108;Cravinhos;2017;15;0,45;13;0,39;2;0,06
3513108;Cravinhos;2018;15;0,44;13;0,38;2;0,06
3513108;Cravinhos;2019;15;0,44;13;0,38;2;0,06
3513207;Cristais Paulista;2010;0;0;0;0;0;0
3513207;Cristais Paulista;2011;0;0;0;0;0;0
3513207;Cristais Paulista;2012;0;0;0;0;0;0
3513207;Cristais Paulista;2013;0;0;0;0;0;0
3513207;Cristais Paulista;2014;0;0;0;0;0;0
3513207;Cristais Paulista;2015;0;0;0;0;0;0
3513207;Cristais Paulista;2016;0;0;0;0;0;0
3513207;Cristais Paulista;2017;0;0;0;0;0;0
3513207;Cristais Paulista;2018;0;0;0;0;0;0
3513207;Cristais Paulista;2019;0;0;0;0;0;0
3513306;Cruzália;2010;0;0;0;0;0;0
3513306;Cruzália;2011;0;0;0;0;0;0
3513306;Cruzália;2012;0;0;0;0;0;0
3513306;Cruzália;2013;0;0;0;0;0;0
3513306;Cruzália;2014;0;0;0;0;0;0
3513306;Cruzália;2015;0;0;0;0;0;0
3513306;Cruzália;2016;0;0;0;0;0;0
3513306;Cruzália;2017;0;0;0;0;0;0
3513306;Cruzália;2018;0;0;0;0;0;0
3513306;Cruzália;2019;0;0;0;0;0;0
3513405;Cruzeiro;2010;152;1,97;107;1,39;45;0,58
3513405;Cruzeiro;2011;152;1,97;107;1,38;45;0,58
3513405;Cruzeiro;2012;152;1,96;107;1,38;45;0,58
3513405;Cruzeiro;2013;156;2;111;1,42;45;0,58
3513405;Cruzeiro;2014;156;1,99;111;1,42;45;0,57
3513405;Cruzeiro;2015;120;1,53;77;0,98;43;0,55
3513405;Cruzeiro;2016;120;1,52;77;0,98;43;0,55
3513405;Cruzeiro;2017;122;1,54;77;0,97;45;0,57
3513405;Cruzeiro;2018;120;1,51;84;1,06;36;0,45
3513405;Cruzeiro;2019;103;1,29;67;0,84;36;0,45
3513504;Cubatão;2010;150;1,26;134;1,13;16;0,13
3513504;Cubatão;2011;150;1,25;134;1,12;16;0,13
3513504;Cubatão;2012;138;1,14;134;1,11;4;0,03
3513504;Cubatão;2013;138;1,13;134;1,1;4;0,03
3513504;Cubatão;2014;138;1,12;134;1,09;4;0,03
3513504;Cubatão;2015;138;1,11;134;1,08;4;0,03
3513504;Cubatão;2016;145;1,16;141;1,13;4;0,03
3513504;Cubatão;2017;118;0,94;66;0,52;52;0,41
3513504;Cubatão;2018;118;0,93;66;0,52;52;0,41
3513504;Cubatão;2019;118;0,92;66;0,52;52;0,41
3513603;Cunha;2010;40;1,83;24;1,1;16;0,73
3513603;Cunha;2011;40;1,83;24;1,1;16;0,73
3513603;Cunha;2012;40;1,83;24;1,1;16;0,73
3513603;Cunha;2013;40;1,84;25;1,15;15;0,69
3513603;Cunha;2014;44;2,02;29;1,33;15;0,69
3513603;Cunha;2015;40;1,84;25;1,15;15;0,69
3513603;Cunha;2016;40;1,84;25;1,15;15;0,69
3513603;Cunha;2017;40;1,84;25;1,15;15;0,69
3513603;Cunha;2018;40;1,84;25;1,15;15;0,69
3513603;Cunha;2019;40;1,84;25;1,15;15;0,69
3513702;Descalvado;2010;57;1,84;23;0,74;34;1,1
3513702;Descalvado;2011;57;1,83;23;0,74;34;1,09
3513702;Descalvado;2012;38;1,21;23;0,73;15;0,48
3513702;Descalvado;2013;38;1,21;23;0,73;15;0,48
3513702;Descalvado;2014;38;1,2;23;0,73;15;0,47
3513702;Descalvado;2015;40;1,26;25;0,79;15;0,47
3513702;Descalvado;2016;40;1,25;25;0,78;15;0,47
3513702;Descalvado;2017;40;1,25;25;0,78;15;0,47
3513702;Descalvado;2018;40;1,24;25;0,78;15;0,47
3513702;Descalvado;2019;40;1,24;25;0,77;15;0,46
3513801;Diadema;2010;565;1,46;492;1,28;73;0,19
3513801;Diadema;2011;567;1,46;494;1,27;73;0,19
3513801;Diadema;2012;658;1,69;585;1,5;73;0,19
3513801;Diadema;2013;720;1,84;574;1,46;146;0,37
3513801;Diadema;2014;635;1,61;566;1,44;69;0,18
3513801;Diadema;2015;635;1,6;566;1,43;69;0,17
3513801;Diadema;2016;624;1,57;555;1,39;69;0,17
3513801;Diadema;2017;624;1,56;545;1,36;79;0,2
3513801;Diadema;2018;634;1,58;555;1,38;79;0,2
3513801;Diadema;2019;624;1,55;555;1,38;69;0,17
3513850;Dirce Reis;2010;0;0;0;0;0;0
3513850;Dirce Reis;2011;0;0;0;0;0;0
3513850;Dirce Reis;2012;0;0;0;0;0;0
3513850;Dirce Reis;2013;0;0;0;0;0;0
3513850;Dirce Reis;2014;0;0;0;0;0;0
3513850;Dirce Reis;2015;0;0;0;0;0;0
3513850;Dirce Reis;2016;0;0;0;0;0;0
3513850;Dirce Reis;2017;0;0;0;0;0;0
3513850;Dirce Reis;2018;0;0;0;0;0;0
3513850;Dirce Reis;2019;0;0;0;0;0;0
3513900;Divinolândia;2010;204;18,19;195;17,39;9;0,8
3513900;Divinolândia;2011;204;18,26;195;17,45;9;0,81
3513900;Divinolândia;2012;198;17,78;198;17,78;0;0
3513900;Divinolândia;2013;198;17,84;198;17,84;0;0
3513900;Divinolândia;2014;198;17,9;198;17,9;0;0
3513900;Divinolândia;2015;192;17,42;192;17,42;0;0
3513900;Divinolândia;2016;192;17,47;192;17,47;0;0
3513900;Divinolândia;2017;186;16,96;186;16,96;0;0
3513900;Divinolândia;2018;186;17;186;17;0;0
3513900;Divinolândia;2019;186;17,04;186;17,04;0;0
3514007;Dobrada;2010;0;0;0;0;0;0
3514007;Dobrada;2011;0;0;0;0;0;0
3514007;Dobrada;2012;0;0;0;0;0;0
3514007;Dobrada;2013;0;0;0;0;0;0
3514007;Dobrada;2014;0;0;0;0;0;0
3514007;Dobrada;2015;0;0;0;0;0;0
3514007;Dobrada;2016;0;0;0;0;0;0
3514007;Dobrada;2017;0;0;0;0;0;0
3514007;Dobrada;2018;0;0;0;0;0;0
3514007;Dobrada;2019;0;0;0;0;0;0
3514106;Dois Córregos;2010;65;2,63;44;1,78;21;0,85
3514106;Dois Córregos;2011;65;2,6;44;1,76;21;0,84
3514106;Dois Córregos;2012;65;2,58;44;1,75;21;0,83
3514106;Dois Córregos;2013;67;2,64;47;1,85;20;0,79
3514106;Dois Córregos;2014;67;2,61;47;1,83;20;0,78
3514106;Dois Córregos;2015;67;2,59;47;1,82;20;0,77
3514106;Dois Córregos;2016;67;2,57;47;1,8;20;0,77
3514106;Dois Córregos;2017;67;2,55;47;1,79;20;0,76
3514106;Dois Córregos;2018;67;2,53;47;1,77;20;0,75
3514106;Dois Córregos;2019;67;2,5;47;1,76;20;0,75
3514205;Dolcinópolis;2010;0;0;0;0;0;0
3514205;Dolcinópolis;2011;0;0;0;0;0;0
3514205;Dolcinópolis;2012;0;0;0;0;0;0
3514205;Dolcinópolis;2013;0;0;0;0;0;0
3514205;Dolcinópolis;2014;0;0;0;0;0;0
3514205;Dolcinópolis;2015;0;0;0;0;0;0
3514205;Dolcinópolis;2016;0;0;0;0;0;0
3514205;Dolcinópolis;2017;0;0;0;0;0;0
3514205;Dolcinópolis;2018;0;0;0;0;0;0
3514205;Dolcinópolis;2019;0;0;0;0;0;0
3514304;Dourado;2010;18;2,09;12;1,39;6;0,7
3514304;Dourado;2011;18;2,09;12;1,4;6;0,7
3514304;Dourado;2012;18;2,1;12;1,4;6;0,7
3514304;Dourado;2013;18;2,1;12;1,4;6;0,7
3514304;Dourado;2014;18;2,1;12;1,4;6;0,7
3514304;Dourado;2015;19;2,22;16;1,87;3;0,35
3514304;Dourado;2016;19;2,23;16;1,88;3;0,35
3514304;Dourado;2017;18;2,11;18;2,11;0;0
3514304;Dourado;2018;14;1,65;14;1,65;0;0
3514304;Dourado;2019;14;1,65;14;1,65;0;0
3514403;Dracena;2010;143;3,31;108;2,5;35;0,81
3514403;Dracena;2011;143;3,29;108;2,49;35;0,81
3514403;Dracena;2012;143;3,28;108;2,48;35;0,8
3514403;Dracena;2013;143;3,26;108;2,46;35;0,8
3514403;Dracena;2014;143;3,25;108;2,45;35;0,79
3514403;Dracena;2015;143;3,23;108;2,44;35;0,79
3514403;Dracena;2016;143;3,22;108;2,43;35;0,79
3514403;Dracena;2017;143;3,21;108;2,42;35;0,79
3514403;Dracena;2018;143;3,2;108;2,42;35;0,78
3514403;Dracena;2019;143;3,19;108;2,41;35;0,78
3514502;Duartina;2010;82;6,69;77;6,28;5;0,41
3514502;Duartina;2011;82;6,71;77;6,3;5;0,41
3514502;Duartina;2012;82;6,72;77;6,31;5;0,41
3514502;Duartina;2013;82;6,74;77;6,33;5;0,41
3514502;Duartina;2014;82;6,75;77;6,34;5;0,41
3514502;Duartina;2015;87;7,18;77;6,36;10;0,83
3514502;Duartina;2016;87;7,2;77;6,37;10;0,83
3514502;Duartina;2017;87;7,21;77;6,39;10;0,83
3514502;Duartina;2018;87;7,23;77;6,4;10;0,83
3514502;Duartina;2019;87;7,25;77;6,42;10;0,83
3514601;Dumont;2010;0;0;0;0;0;0
3514601;Dumont;2011;0;0;0;0;0;0
3514601;Dumont;2012;0;0;0;0;0;0
3514601;Dumont;2013;0;0;0;0;0;0
3514601;Dumont;2014;0;0;0;0;0;0
3514601;Dumont;2015;0;0;0;0;0;0
3514601;Dumont;2016;0;0;0;0;0;0
3514601;Dumont;2017;0;0;0;0;0;0
3514601;Dumont;2018;0;0;0;0;0;0
3514601;Dumont;2019;0;0;0;0;0;0
3514700;Echaporã;2010;0;0;0;0;0;0
3514700;Echaporã;2011;0;0;0;0;0;0
3514700;Echaporã;2012;0;0;0;0;0;0
3514700;Echaporã;2013;0;0;0;0;0;0
3514700;Echaporã;2014;0;0;0;0;0;0
3514700;Echaporã;2015;0;0;0;0;0;0
3514700;Echaporã;2016;0;0;0;0;0;0
3514700;Echaporã;2017;0;0;0;0;0;0
3514700;Echaporã;2018;0;0;0;0;0;0
3514700;Echaporã;2019;0;0;0;0;0;0
3514809;Eldorado;2010;7;0,48;7;0,48;0;0
3514809;Eldorado;2011;7;0,48;7;0,48;0;0
3514809;Eldorado;2012;2;0,14;2;0,14;0;0
3514809;Eldorado;2013;2;0,14;2;0,14;0;0
3514809;Eldorado;2014;2;0,14;2;0,14;0;0
3514809;Eldorado;2015;2;0,13;2;0,13;0;0
3514809;Eldorado;2016;2;0,13;2;0,13;0;0
3514809;Eldorado;2017;2;0,13;2;0,13;0;0
3514809;Eldorado;2018;2;0,13;2;0,13;0;0
3514809;Eldorado;2019;2;0,13;2;0,13;0;0
3514908;Elias Fausto;2010;6;0,38;6;0,38;0;0
3514908;Elias Fausto;2011;6;0,38;6;0,38;0;0
3514908;Elias Fausto;2012;6;0,37;6;0,37;0;0
3514908;Elias Fausto;2013;6;0,37;6;0,37;0;0
3514908;Elias Fausto;2014;6;0,37;6;0,37;0;0
3514908;Elias Fausto;2015;6;0,36;6;0,36;0;0
3514908;Elias Fausto;2016;6;0,36;6;0,36;0;0
3514908;Elias Fausto;2017;6;0,36;6;0,36;0;0
3514908;Elias Fausto;2018;6;0,35;6;0,35;0;0
3514908;Elias Fausto;2019;6;0,35;6;0,35;0;0
3514924;Elisiário;2010;0;0;0;0;0;0
3514924;Elisiário;2011;0;0;0;0;0;0
3514924;Elisiário;2012;0;0;0;0;0;0
3514924;Elisiário;2013;0;0;0;0;0;0
3514924;Elisiário;2014;0;0;0;0;0;0
3514924;Elisiário;2015;0;0;0;0;0;0
3514924;Elisiário;2016;0;0;0;0;0;0
3514924;Elisiário;2017;0;0;0;0;0;0
3514924;Elisiário;2018;0;0;0;0;0;0
3514924;Elisiário;2019;0;0;0;0;0;0
3514957;Embaúba;2010;0;0;0;0;0;0
3514957;Embaúba;2011;0;0;0;0;0;0
3514957;Embaúba;2012;0;0;0;0;0;0
3514957;Embaúba;2013;0;0;0;0;0;0
3514957;Embaúba;2014;0;0;0;0;0;0
3514957;Embaúba;2015;0;0;0;0;0;0
3514957;Embaúba;2016;0;0;0;0;0;0
3514957;Embaúba;2017;0;0;0;0;0;0
3514957;Embaúba;2018;0;0;0;0;0;0
3514957;Embaúba;2019;0;0;0;0;0;0
3515004;Embu das Artes;2010;81;0,34;81;0,34;0;0
3515004;Embu das Artes;2011;83;0,34;83;0,34;0;0
3515004;Embu das Artes;2012;77;0,31;77;0,31;0;0
3515004;Embu das Artes;2013;71;0,28;71;0,28;0;0
3515004;Embu das Artes;2014;72;0,28;72;0,28;0;0
3515004;Embu das Artes;2015;81;0,32;76;0,3;5;0,02
3515004;Embu das Artes;2016;94;0,36;89;0,34;5;0,02
3515004;Embu das Artes;2017;94;0,36;89;0,34;5;0,02
3515004;Embu das Artes;2018;94;0,36;89;0,34;5;0,02
3515004;Embu das Artes;2019;244;0,91;89;0,33;155;0,58
3515103;Embu-Guaçu;2010;21;0,33;21;0,33;0;0
3515103;Embu-Guaçu;2011;21;0,33;21;0,33;0;0
3515103;Embu-Guaçu;2012;16;0,25;16;0,25;0;0
3515103;Embu-Guaçu;2013;16;0,25;16;0,25;0;0
3515103;Embu-Guaçu;2014;16;0,25;16;0,25;0;0
3515103;Embu-Guaçu;2015;16;0,24;16;0,24;0;0
3515103;Embu-Guaçu;2016;16;0,24;16;0,24;0;0
3515103;Embu-Guaçu;2017;16;0,24;16;0,24;0;0
3515103;Embu-Guaçu;2018;16;0,24;16;0,24;0;0
3515103;Embu-Guaçu;2019;17;0,25;17;0,25;0;0
3515129;Emilianópolis;2010;0;0;0;0;0;0
3515129;Emilianópolis;2011;0;0;0;0;0;0
3515129;Emilianópolis;2012;0;0;0;0;0;0
3515129;Emilianópolis;2013;0;0;0;0;0;0
3515129;Emilianópolis;2014;0;0;0;0;0;0
3515129;Emilianópolis;2015;0;0;0;0;0;0
3515129;Emilianópolis;2016;0;0;0;0;0;0
3515129;Emilianópolis;2017;0;0;0;0;0;0
3515129;Emilianópolis;2018;0;0;0;0;0;0
3515129;Emilianópolis;2019;0;0;0;0;0;0
3515152;Engenheiro Coelho;2010;0;0;0;0;0;0
3515152;Engenheiro Coelho;2011;0;0;0;0;0;0
3515152;Engenheiro Coelho;2012;0;0;0;0;0;0
3515152;Engenheiro Coelho;2013;0;0;0;0;0;0
3515152;Engenheiro Coelho;2014;0;0;0;0;0;0
3515152;Engenheiro Coelho;2015;0;0;0;0;0;0
3515152;Engenheiro Coelho;2016;0;0;0;0;0;0
3515152;Engenheiro Coelho;2017;0;0;0;0;0;0
3515152;Engenheiro Coelho;2018;0;0;0;0;0;0
3515152;Engenheiro Coelho;2019;0;0;0;0;0;0
3515186;Espírito Santo do Pinhal;2010;465;11,1;373;8,9;92;2,2
3515186;Espírito Santo do Pinhal;2011;465;11,08;373;8,89;92;2,19
3515186;Espírito Santo do Pinhal;2012;458;10,89;369;8,77;89;2,12
3515186;Espírito Santo do Pinhal;2013;458;10,87;369;8,76;89;2,11
3515186;Espírito Santo do Pinhal;2014;458;10,85;369;8,74;89;2,11
3515186;Espírito Santo do Pinhal;2015;458;10,83;369;8,72;89;2,1
3515186;Espírito Santo do Pinhal;2016;454;10,72;366;8,64;88;2,08
3515186;Espírito Santo do Pinhal;2017;453;10,68;365;8,61;88;2,08
3515186;Espírito Santo do Pinhal;2018;453;10,67;361;8,5;92;2,17
3515186;Espírito Santo do Pinhal;2019;452;10,63;354;8,33;98;2,3
3515194;Espírito Santo do Turvo;2010;0;0;0;0;0;0
3515194;Espírito Santo do Turvo;2011;0;0;0;0;0;0
3515194;Espírito Santo do Turvo;2012;0;0;0;0;0;0
3515194;Espírito Santo do Turvo;2013;0;0;0;0;0;0
3515194;Espírito Santo do Turvo;2014;0;0;0;0;0;0
3515194;Espírito Santo do Turvo;2015;0;0;0;0;0;0
3515194;Espírito Santo do Turvo;2016;0;0;0;0;0;0
3515194;Espírito Santo do Turvo;2017;0;0;0;0;0;0
3515194;Espírito Santo do Turvo;2018;0;0;0;0;0;0
3515194;Espírito Santo do Turvo;2019;0;0;0;0;0;0
3557303;Estiva Gerbi;2010;0;0;0;0;0;0
3557303;Estiva Gerbi;2011;0;0;0;0;0;0
3557303;Estiva Gerbi;2012;0;0;0;0;0;0
3557303;Estiva Gerbi;2013;0;0;0;0;0;0
3557303;Estiva Gerbi;2014;0;0;0;0;0;0
3557303;Estiva Gerbi;2015;0;0;0;0;0;0
3557303;Estiva Gerbi;2016;0;0;0;0;0;0
3557303;Estiva Gerbi;2017;0;0;0;0;0;0
3557303;Estiva Gerbi;2018;0;0;0;0;0;0
3557303;Estiva Gerbi;2019;0;0;0;0;0;0
3515202;Estrela d'Oeste;2010;14;1,71;9;1,1;5;0,61
3515202;Estrela d'Oeste;2011;14;1,71;9;1,1;5;0,61
3515202;Estrela d'Oeste;2012;14;1,71;9;1,1;5;0,61
3515202;Estrela d'Oeste;2013;50;6,11;30;3,67;20;2,45
3515202;Estrela d'Oeste;2014;50;6,12;30;3,67;20;2,45
3515202;Estrela d'Oeste;2015;50;6,13;30;3,68;20;2,45
3515202;Estrela d'Oeste;2016;50;6,14;30;3,68;20;2,46
3515202;Estrela d'Oeste;2017;50;6,15;45;5,53;5;0,61
3515202;Estrela d'Oeste;2018;50;6,16;45;5,54;5;0,62
3515202;Estrela d'Oeste;2019;66;8,14;61;7,52;5;0,62
3515301;Estrela do Norte;2010;0;0;0;0;0;0
3515301;Estrela do Norte;2011;0;0;0;0;0;0
3515301;Estrela do Norte;2012;0;0;0;0;0;0
3515301;Estrela do Norte;2013;0;0;0;0;0;0
3515301;Estrela do Norte;2014;0;0;0;0;0;0
3515301;Estrela do Norte;2015;0;0;0;0;0;0
3515301;Estrela do Norte;2016;0;0;0;0;0;0
3515301;Estrela do Norte;2017;0;0;0;0;0;0
3515301;Estrela do Norte;2018;0;0;0;0;0;0
3515301;Estrela do Norte;2019;0;0;0;0;0;0
3515350;Euclides da Cunha Paulista;2010;0;0;0;0;0;0
3515350;Euclides da Cunha Paulista;2011;0;0;0;0;0;0
3515350;Euclides da Cunha Paulista;2012;0;0;0;0;0;0
3515350;Euclides da Cunha Paulista;2013;0;0;0;0;0;0
3515350;Euclides da Cunha Paulista;2014;0;0;0;0;0;0
3515350;Euclides da Cunha Paulista;2015;0;0;0;0;0;0
3515350;Euclides da Cunha Paulista;2016;0;0;0;0;0;0
3515350;Euclides da Cunha Paulista;2017;0;0;0;0;0;0
3515350;Euclides da Cunha Paulista;2018;0;0;0;0;0;0
3515350;Euclides da Cunha Paulista;2019;0;0;0;0;0;0
3515400;Fartura;2010;26;1,7;17;1,11;9;0,59
3515400;Fartura;2011;26;1,69;17;1,11;9;0,59
3515400;Fartura;2012;26;1,69;17;1,11;9;0,59
3515400;Fartura;2013;26;1,69;17;1,1;9;0,58
3515400;Fartura;2014;26;1,68;17;1,1;9;0,58
3515400;Fartura;2015;20;1,29;12;0,78;8;0,52
3515400;Fartura;2016;20;1,29;12;0,77;8;0,52
3515400;Fartura;2017;20;1,29;12;0,77;8;0,51
3515400;Fartura;2018;20;1,28;12;0,77;8;0,51
3515400;Fartura;2019;20;1,28;12;0,77;8;0,51
3515608;Fernando Prestes;2010;0;0;0;0;0;0
3515608;Fernando Prestes;2011;0;0;0;0;0;0
3515608;Fernando Prestes;2012;0;0;0;0;0;0
3515608;Fernando Prestes;2013;0;0;0;0;0;0
3515608;Fernando Prestes;2014;0;0;0;0;0;0
3515608;Fernando Prestes;2015;0;0;0;0;0;0
3515608;Fernando Prestes;2016;0;0;0;0;0;0
3515608;Fernando Prestes;2017;0;0;0;0;0;0
3515608;Fernando Prestes;2018;0;0;0;0;0;0
3515608;Fernando Prestes;2019;0;0;0;0;0;0
3515509;Fernandópolis;2010;172;2,66;92;1,42;80;1,24
3515509;Fernandópolis;2011;172;2,65;92;1,42;80;1,23
3515509;Fernandópolis;2012;172;2,65;92;1,41;80;1,23
3515509;Fernandópolis;2013;172;2,64;92;1,41;80;1,23
3515509;Fernandópolis;2014;180;2,75;90;1,38;90;1,38
3515509;Fernandópolis;2015;180;2,75;84;1,28;96;1,46
3515509;Fernandópolis;2016;130;1,98;84;1,28;46;0,7
3515509;Fernandópolis;2017;135;2,05;84;1,28;51;0,78
3515509;Fernandópolis;2018;135;2,05;84;1,27;51;0,77
3515509;Fernandópolis;2019;135;2,05;84;1,27;51;0,77
3515657;Fernão;2010;0;0;0;0;0;0
3515657;Fernão;2011;0;0;0;0;0;0
3515657;Fernão;2012;0;0;0;0;0;0
3515657;Fernão;2013;0;0;0;0;0;0
3515657;Fernão;2014;0;0;0;0;0;0
3515657;Fernão;2015;0;0;0;0;0;0
3515657;Fernão;2016;0;0;0;0;0;0
3515657;Fernão;2017;0;0;0;0;0;0
3515657;Fernão;2018;0;0;0;0;0;0
3515657;Fernão;2019;0;0;0;0;0;0
3515707;Ferraz de Vasconcelos;2010;189;1,12;189;1,12;0;0
3515707;Ferraz de Vasconcelos;2011;193;1,13;193;1,13;0;0
3515707;Ferraz de Vasconcelos;2012;193;1,12;193;1,12;0;0
3515707;Ferraz de Vasconcelos;2013;193;1,1;193;1,1;0;0
3515707;Ferraz de Vasconcelos;2014;258;1,45;258;1,45;0;0
3515707;Ferraz de Vasconcelos;2015;191;1,06;191;1,06;0;0
3515707;Ferraz de Vasconcelos;2016;189;1,03;189;1,03;0;0
3515707;Ferraz de Vasconcelos;2017;189;1,02;189;1,02;0;0
3515707;Ferraz de Vasconcelos;2018;189;1,01;189;1,01;0;0
3515707;Ferraz de Vasconcelos;2019;189;0,99;189;0,99;0;0
3515806;Flora Rica;2010;0;0;0;0;0;0
3515806;Flora Rica;2011;0;0;0;0;0;0
3515806;Flora Rica;2012;0;0;0;0;0;0
3515806;Flora Rica;2013;0;0;0;0;0;0
3515806;Flora Rica;2014;0;0;0;0;0;0
3515806;Flora Rica;2015;0;0;0;0;0;0
3515806;Flora Rica;2016;0;0;0;0;0;0
3515806;Flora Rica;2017;0;0;0;0;0;0
3515806;Flora Rica;2018;0;0;0;0;0;0
3515806;Flora Rica;2019;0;0;0;0;0;0
3515905;Floreal;2010;0;0;0;0;0;0
3515905;Floreal;2011;0;0;0;0;0;0
3515905;Floreal;2012;0;0;0;0;0;0
3515905;Floreal;2013;0;0;0;0;0;0
3515905;Floreal;2014;0;0;0;0;0;0
3515905;Floreal;2015;0;0;0;0;0;0
3515905;Floreal;2016;0;0;0;0;0;0
3515905;Floreal;2017;0;0;0;0;0;0
3515905;Floreal;2018;0;0;0;0;0;0
3515905;Floreal;2019;0;0;0;0;0;0
3516002;Flórida Paulista;2010;47;3,66;30;2,34;17;1,32
3516002;Flórida Paulista;2011;47;3,69;30;2,35;17;1,33
3516002;Flórida Paulista;2012;47;3,71;30;2,37;17;1,34
3516002;Flórida Paulista;2013;47;3,73;30;2,38;17;1,35
3516002;Flórida Paulista;2014;47;3,75;30;2,4;17;1,36
3516002;Flórida Paulista;2015;47;3,78;30;2,41;17;1,37
3516002;Flórida Paulista;2016;47;3,8;30;2,42;17;1,37
3516002;Flórida Paulista;2017;47;3,82;30;2,44;17;1,38
3516002;Flórida Paulista;2018;47;3,84;30;2,45;17;1,39
3516002;Flórida Paulista;2019;47;3,86;30;2,46;17;1,4
3516101;Florínea;2010;0;0;0;0;0;0
3516101;Florínea;2011;0;0;0;0;0;0
3516101;Florínea;2012;0;0;0;0;0;0
3516101;Florínea;2013;0;0;0;0;0;0
3516101;Florínea;2014;0;0;0;0;0;0
3516101;Florínea;2015;0;0;0;0;0;0
3516101;Florínea;2016;0;0;0;0;0;0
3516101;Florínea;2017;0;0;0;0;0;0
3516101;Florínea;2018;0;0;0;0;0;0
3516101;Florínea;2019;0;0;0;0;0;0
3516200;Franca;2010;678;2,13;418;1,31;260;0,82
3516200;Franca;2011;678;2,11;418;1,3;260;0,81
3516200;Franca;2012;663;2,05;424;1,31;239;0,74
3516200;Franca;2013;720;2,21;456;1,4;264;0,81
3516200;Franca;2014;720;2,19;456;1,39;264;0,8
3516200;Franca;2015;739;2,23;487;1,47;252;0,76
3516200;Franca;2016;747;2,24;471;1,41;276;0,83
3516200;Franca;2017;738;2,2;486;1,45;252;0,75
3516200;Franca;2018;736;2,18;482;1,43;254;0,75
3516200;Franca;2019;739;2,17;488;1,44;251;0,74
3516309;Francisco Morato;2010;144;0,93;95;0,62;49;0,32
3516309;Francisco Morato;2011;144;0,92;95;0,61;49;0,31
3516309;Francisco Morato;2012;144;0,91;95;0,6;49;0,31
3516309;Francisco Morato;2013;144;0,9;95;0,59;49;0,31
3516309;Francisco Morato;2014;144;0,89;111;0,68;33;0,2
3516309;Francisco Morato;2015;144;0,88;95;0,58;49;0,3
3516309;Francisco Morato;2016;147;0,89;98;0,59;49;0,3
3516309;Francisco Morato;2017;147;0,87;98;0,58;49;0,29
3516309;Francisco Morato;2018;147;0,86;98;0,58;49;0,29
3516309;Francisco Morato;2019;98;0,57;98;0,57;0;0
3516408;Franco da Rocha;2010;635;4,83;405;3,08;230;1,75
3516408;Franco da Rocha;2011;670;5,02;440;3,3;230;1,72
3516408;Franco da Rocha;2012;654;4,82;424;3,13;230;1,7
3516408;Franco da Rocha;2013;654;4,75;424;3,08;230;1,67
3516408;Franco da Rocha;2014;719;5,14;427;3,05;292;2,09
3516408;Franco da Rocha;2015;396;2,78;314;2,21;82;0,58
3516408;Franco da Rocha;2016;692;4,8;610;4,23;82;0,57
3516408;Franco da Rocha;2017;672;4,6;590;4,04;82;0,56
3516408;Franco da Rocha;2018;693;4,68;611;4,12;82;0,55
3516408;Franco da Rocha;2019;693;4,62;611;4,07;82;0,55
3516507;Gabriel Monteiro;2010;0;0;0;0;0;0
3516507;Gabriel Monteiro;2011;0;0;0;0;0;0
3516507;Gabriel Monteiro;2012;0;0;0;0;0;0
3516507;Gabriel Monteiro;2013;0;0;0;0;0;0
3516507;Gabriel Monteiro;2014;0;0;0;0;0;0
3516507;Gabriel Monteiro;2015;0;0;0;0;0;0
3516507;Gabriel Monteiro;2016;0;0;0;0;0;0
3516507;Gabriel Monteiro;2017;0;0;0;0;0;0
3516507;Gabriel Monteiro;2018;0;0;0;0;0;0
3516507;Gabriel Monteiro;2019;0;0;0;0;0;0
3516606;Gália;2010;45;6,41;24;3,42;21;2,99
3516606;Gália;2011;45;6,47;24;3,45;21;3,02
3516606;Gália;2012;45;6,52;24;3,48;21;3,04
3516606;Gália;2013;45;6,58;24;3,51;21;3,07
3516606;Gália;2014;45;6,63;24;3,54;21;3,09
3516606;Gália;2015;45;6,69;24;3,57;21;3,12
3516606;Gália;2016;45;6,72;24;3,58;21;3,14
3516606;Gália;2017;45;6,75;27;4,05;18;2,7
3516606;Gália;2018;45;6,79;27;4,07;18;2,72
3516606;Gália;2019;45;6,82;27;4,09;18;2,73
3516705;Garça;2010;376;8,72;331;7,68;45;1,04
3516705;Garça;2011;376;8,73;331;7,69;45;1,05
3516705;Garça;2012;376;8,75;331;7,7;45;1,05
3516705;Garça;2013;376;8,76;331;7,71;45;1,05
3516705;Garça;2014;376;8,78;331;7,73;45;1,05
3516705;Garça;2015;377;8,81;332;7,76;45;1,05
3516705;Garça;2016;377;8,83;332;7,77;45;1,05
3516705;Garça;2017;365;8,56;332;7,78;33;0,77
3516705;Garça;2018;312;7,32;270;6,34;42;0,99
3516705;Garça;2019;281;6,61;252;5,92;29;0,68
3516804;Gastão Vidigal;2010;0;0;0;0;0;0
3516804;Gastão Vidigal;2011;0;0;0;0;0;0
3516804;Gastão Vidigal;2012;0;0;0;0;0;0
3516804;Gastão Vidigal;2013;0;0;0;0;0;0
3516804;Gastão Vidigal;2014;0;0;0;0;0;0
3516804;Gastão Vidigal;2015;0;0;0;0;0;0
3516804;Gastão Vidigal;2016;0;0;0;0;0;0
3516804;Gastão Vidigal;2017;0;0;0;0;0;0
3516804;Gastão Vidigal;2018;0;0;0;0;0;0
3516804;Gastão Vidigal;2019;0;0;0;0;0;0
3516853;Gavião Peixoto;2010;0;0;0;0;0;0
3516853;Gavião Peixoto;2011;0;0;0;0;0;0
3516853;Gavião Peixoto;2012;0;0;0;0;0;0
3516853;Gavião Peixoto;2013;0;0;0;0;0;0
3516853;Gavião Peixoto;2014;0;0;0;0;0;0
3516853;Gavião Peixoto;2015;0;0;0;0;0;0
3516853;Gavião Peixoto;2016;0;0;0;0;0;0
3516853;Gavião Peixoto;2017;0;0;0;0;0;0
3516853;Gavião Peixoto;2018;0;0;0;0;0;0
3516853;Gavião Peixoto;2019;0;0;0;0;0;0
3516903;General Salgado;2010;32;3;11;1,03;21;1,97
3516903;General Salgado;2011;32;3;11;1,03;21;1,97
3516903;General Salgado;2012;32;3;11;1,03;21;1,97
3516903;General Salgado;2013;32;3;11;1,03;21;1,97
3516903;General Salgado;2014;32;3;8;0,75;24;2,25
3516903;General Salgado;2015;32;2,99;8;0,75;24;2,25
3516903;General Salgado;2016;32;3;8;0,75;24;2,25
3516903;General Salgado;2017;32;3;20;1,87;12;1,12
3516903;General Salgado;2018;32;3;20;1,88;12;1,13
3516903;General Salgado;2019;32;3;20;1,88;12;1,13
3517000;Getulina;2010;51;4,74;42;3,9;9;0,84
3517000;Getulina;2011;51;4,74;42;3,9;9;0,84
3517000;Getulina;2012;51;4,73;42;3,9;9;0,84
3517000;Getulina;2013;51;4,73;42;3,9;9;0,83
3517000;Getulina;2014;51;4,73;42;3,89;9;0,83
3517000;Getulina;2015;48;4,45;36;3,33;12;1,11
3517000;Getulina;2016;48;4,44;36;3,33;12;1,11
3517000;Getulina;2017;48;4,44;36;3,33;12;1,11
3517000;Getulina;2018;48;4,43;36;3,33;12;1,11
3517000;Getulina;2019;48;4,43;36;3,32;12;1,11
3517109;Glicério;2010;0;0;0;0;0;0
3517109;Glicério;2011;0;0;0;0;0;0
3517109;Glicério;2012;0;0;0;0;0;0
3517109;Glicério;2013;0;0;0;0;0;0
3517109;Glicério;2014;0;0;0;0;0;0
3517109;Glicério;2015;0;0;0;0;0;0
3517109;Glicério;2016;0;0;0;0;0;0
3517109;Glicério;2017;0;0;0;0;0;0
3517109;Glicério;2018;0;0;0;0;0;0
3517109;Glicério;2019;0;0;0;0;0;0
3517307;Guaimbê;2010;0;0;0;0;0;0
3517307;Guaimbê;2011;0;0;0;0;0;0
3517307;Guaimbê;2012;0;0;0;0;0;0
3517307;Guaimbê;2013;0;0;0;0;0;0
3517307;Guaimbê;2014;0;0;0;0;0;0
3517307;Guaimbê;2015;0;0;0;0;0;0
3517307;Guaimbê;2016;0;0;0;0;0;0
3517307;Guaimbê;2017;0;0;0;0;0;0
3517307;Guaimbê;2018;0;0;0;0;0;0
3517307;Guaimbê;2019;0;0;0;0;0;0
3517406;Guaíra;2010;60;1,61;42;1,12;18;0,48
3517406;Guaíra;2011;60;1,6;42;1,12;18;0,48
3517406;Guaíra;2012;70;1,85;43;1,14;27;0,72
3517406;Guaíra;2013;60;1,58;42;1,11;18;0,47
3517406;Guaíra;2014;60;1,57;42;1,1;18;0,47
3517406;Guaíra;2015;60;1,57;42;1,1;18;0,47
3517406;Guaíra;2016;60;1,56;42;1,09;18;0,47
3517406;Guaíra;2017;60;1,55;42;1,09;18;0,47
3517406;Guaíra;2018;60;1,55;42;1,08;18;0,46
3517406;Guaíra;2019;60;1,54;42;1,08;18;0,46
3517208;Guaiçara;2010;0;0;0;0;0;0
3517208;Guaiçara;2011;0;0;0;0;0;0
3517208;Guaiçara;2012;0;0;0;0;0;0
3517208;Guaiçara;2013;0;0;0;0;0;0
3517208;Guaiçara;2014;0;0;0;0;0;0
3517208;Guaiçara;2015;0;0;0;0;0;0
3517208;Guaiçara;2016;0;0;0;0;0;0
3517208;Guaiçara;2017;0;0;0;0;0;0
3517208;Guaiçara;2018;0;0;0;0;0;0
3517208;Guaiçara;2019;0;0;0;0;0;0
3517604;Guapiara;2010;18;1;18;1;0;0
3517604;Guapiara;2011;18;1;18;1;0;0
3517604;Guapiara;2012;19;1,06;19;1,06;0;0
3517604;Guapiara;2013;19;1,07;19;1,07;0;0
3517604;Guapiara;2014;19;1,07;19;1,07;0;0
3517604;Guapiara;2015;19;1,07;19;1,07;0;0
3517604;Guapiara;2016;19;1,07;19;1,07;0;0
3517604;Guapiara;2017;19;1,07;19;1,07;0;0
3517604;Guapiara;2018;19;1,07;19;1,07;0;0
3517604;Guapiara;2019;27;1,52;27;1,52;0;0
3517505;Guapiaçu;2010;0;0;0;0;0;0
3517505;Guapiaçu;2011;0;0;0;0;0;0
3517505;Guapiaçu;2012;0;0;0;0;0;0
3517505;Guapiaçu;2013;0;0;0;0;0;0
3517505;Guapiaçu;2014;0;0;0;0;0;0
3517505;Guapiaçu;2015;0;0;0;0;0;0
3517505;Guapiaçu;2016;0;0;0;0;0;0
3517505;Guapiaçu;2017;0;0;0;0;0;0
3517505;Guapiaçu;2018;0;0;0;0;0;0
3517505;Guapiaçu;2019;0;0;0;0;0;0
3517703;Guará;2010;38;1,91;30;1,51;8;0,4
3517703;Guará;2011;30;1,5;22;1,1;8;0,4
3517703;Guará;2012;30;1,5;22;1,1;8;0,4
3517703;Guará;2013;30;1,49;22;1,09;8;0,4
3517703;Guará;2014;30;1,48;22;1,09;8;0,4
3517703;Guará;2015;30;1,48;22;1,08;8;0,39
3517703;Guará;2016;30;1,47;22;1,08;8;0,39
3517703;Guará;2017;30;1,46;22;1,07;8;0,39
3517703;Guará;2018;30;1,45;22;1,07;8;0,39
3517703;Guará;2019;50;2,41;40;1,93;10;0,48
3517901;Guaraci;2010;0;0;0;0;0;0
3517901;Guaraci;2011;0;0;0;0;0;0
3517901;Guaraci;2012;0;0;0;0;0;0
3517901;Guaraci;2013;0;0;0;0;0;0
3517901;Guaraci;2014;0;0;0;0;0;0
3517901;Guaraci;2015;0;0;0;0;0;0
3517901;Guaraci;2016;0;0;0;0;0;0
3517901;Guaraci;2017;0;0;0;0;0;0
3517901;Guaraci;2018;0;0;0;0;0;0
3517901;Guaraci;2019;0;0;0;0;0;0
3518008;Guarani d'Oeste;2010;0;0;0;0;0;0
3518008;Guarani d'Oeste;2011;0;0;0;0;0;0
3518008;Guarani d'Oeste;2012;0;0;0;0;0;0
3518008;Guarani d'Oeste;2013;0;0;0;0;0;0
3518008;Guarani d'Oeste;2014;0;0;0;0;0;0
3518008;Guarani d'Oeste;2015;0;0;0;0;0;0
3518008;Guarani d'Oeste;2016;0;0;0;0;0;0
3518008;Guarani d'Oeste;2017;0;0;0;0;0;0
3518008;Guarani d'Oeste;2018;0;0;0;0;0;0
3518008;Guarani d'Oeste;2019;0;0;0;0;0;0
3518107;Guarantã;2010;28;4,37;24;3,75;4;0,62
3518107;Guarantã;2011;0;0;0;0;0;0
3518107;Guarantã;2012;0;0;0;0;0;0
3518107;Guarantã;2013;0;0;0;0;0;0
3518107;Guarantã;2014;0;0;0;0;0;0
3518107;Guarantã;2015;0;0;0;0;0;0
3518107;Guarantã;2016;0;0;0;0;0;0
3518107;Guarantã;2017;0;0;0;0;0;0
3518107;Guarantã;2018;0;0;0;0;0;0
3518107;Guarantã;2019;0;0;0;0;0;0
3518206;Guararapes;2010;74;2,42;30;0,98;44;1,44
3518206;Guararapes;2011;74;2,41;30;0,98;44;1,43
3518206;Guararapes;2012;74;2,39;30;0,97;44;1,42
3518206;Guararapes;2013;74;2,38;30;0,96;44;1,41
3518206;Guararapes;2014;74;2,37;30;0,96;44;1,41
3518206;Guararapes;2015;74;2,35;30;0,95;44;1,4
3518206;Guararapes;2016;74;2,34;30;0,95;44;1,39
3518206;Guararapes;2017;74;2,33;48;1,51;26;0,82
3518206;Guararapes;2018;74;2,33;48;1,51;26;0,82
3518206;Guararapes;2019;74;2,32;48;1,5;26;0,81
3518305;Guararema;2010;35;1,36;28;1,08;7;0,27
3518305;Guararema;2011;35;1,34;28;1,07;7;0,27
3518305;Guararema;2012;35;1,32;28;1,06;7;0,26
3518305;Guararema;2013;35;1,3;28;1,04;7;0,26
3518305;Guararema;2014;35;1,28;29;1,06;6;0,22
3518305;Guararema;2015;35;1,27;29;1,05;6;0,22
3518305;Guararema;2016;35;1,25;29;1,04;6;0,21
3518305;Guararema;2017;35;1,24;29;1,02;6;0,21
3518305;Guararema;2018;35;1,22;29;1,01;6;0,21
3518305;Guararema;2019;35;1,2;29;1;6;0,21
3518404;Guaratinguetá;2010;316;2,82;274;2,45;42;0,37
3518404;Guaratinguetá;2011;316;2,8;274;2,43;42;0,37
3518404;Guaratinguetá;2012;326;2,88;274;2,42;52;0,46
3518404;Guaratinguetá;2013;303;2,66;210;1,84;93;0,82
3518404;Guaratinguetá;2014;303;2,64;210;1,83;93;0,81
3518404;Guaratinguetá;2015;278;2,41;162;1,4;116;1
3518404;Guaratinguetá;2016;272;2,34;162;1,4;110;0,95
3518404;Guaratinguetá;2017;244;2,09;156;1,34;88;0,75
3518404;Guaratinguetá;2018;244;2,08;156;1,33;88;0,75
3518404;Guaratinguetá;2019;265;2,25;156;1,32;109;0,93
3517802;Guaraçaí;2010;27;3,2;20;2,37;7;0,83
3517802;Guaraçaí;2011;27;3,2;20;2,37;7;0,83
3517802;Guaraçaí;2012;27;3,2;20;2,37;7;0,83
3517802;Guaraçaí;2013;27;3,2;20;2,37;7;0,83
3517802;Guaraçaí;2014;27;3,2;20;2,37;7;0,83
3517802;Guaraçaí;2015;27;3,2;20;2,37;7;0,83
3517802;Guaraçaí;2016;23;2,73;15;1,78;8;0,95
3517802;Guaraçaí;2017;23;2,73;15;1,78;8;0,95
3517802;Guaraçaí;2018;23;2,73;15;1,78;8;0,95
3517802;Guaraçaí;2019;23;2,73;15;1,78;8;0,95
3518503;Guareí;2010;0;0;0;0;0;0
3518503;Guareí;2011;0;0;0;0;0;0
3518503;Guareí;2012;0;0;0;0;0;0
3518503;Guareí;2013;0;0;0;0;0;0
3518503;Guareí;2014;0;0;0;0;0;0
3518503;Guareí;2015;0;0;0;0;0;0
3518503;Guareí;2016;0;0;0;0;0;0
3518503;Guareí;2017;0;0;0;0;0;0
3518503;Guareí;2018;0;0;0;0;0;0
3518503;Guareí;2019;0;0;0;0;0;0
3518602;Guariba;2010;72;2,03;51;1,44;21;0,59
3518602;Guariba;2011;72;2,01;51;1,42;21;0,59
3518602;Guariba;2012;72;1,99;51;1,41;21;0,58
3518602;Guariba;2013;72;1,97;50;1,37;22;0,6
3518602;Guariba;2014;72;1,95;50;1,35;22;0,6
3518602;Guariba;2015;72;1,93;65;1,74;7;0,19
3518602;Guariba;2016;72;1,91;65;1,73;7;0,19
3518602;Guariba;2017;72;1,89;65;1,71;7;0,18
3518602;Guariba;2018;67;1,75;60;1,56;7;0,18
3518602;Guariba;2019;66;1,71;59;1,53;7;0,18
3518701;Guarujá;2010;356;1,23;259;0,89;97;0,33
3518701;Guarujá;2011;306;1,04;212;0,72;94;0,32
3518701;Guarujá;2012;276;0,93;208;0,7;68;0,23
3518701;Guarujá;2013;305;1,02;237;0,79;68;0,23
3518701;Guarujá;2014;331;1,1;263;0,87;68;0,23
3518701;Guarujá;2015;321;1,06;234;0,77;87;0,29
3518701;Guarujá;2016;323;1,06;217;0,71;106;0,35
3518701;Guarujá;2017;391;1,27;219;0,71;172;0,56
3518701;Guarujá;2018;336;1,08;225;0,72;111;0,36
3518701;Guarujá;2019;336;1,07;225;0,72;111;0,35
3518800;Guarulhos;2010;1954;1,6;1429;1,17;525;0,43
3518800;Guarulhos;2011;1859;1,51;1413;1,15;446;0,36
3518800;Guarulhos;2012;1922;1,54;1432;1,15;490;0,39
3518800;Guarulhos;2013;1928;1,53;1441;1,14;487;0,39
3518800;Guarulhos;2014;1846;1,45;1428;1,12;418;0,33
3518800;Guarulhos;2015;1847;1,43;1429;1,11;418;0,32
3518800;Guarulhos;2016;1909;1,47;1453;1,12;456;0,35
3518800;Guarulhos;2017;1991;1,52;1456;1,11;535;0,41
3518800;Guarulhos;2018;1996;1,51;1444;1,09;552;0,42
3518800;Guarulhos;2019;1987;1,48;1444;1,08;543;0,41
3518859;Guatapará;2010;0;0;0;0;0;0
3518859;Guatapará;2011;0;0;0;0;0;0
3518859;Guatapará;2012;0;0;0;0;0;0
3518859;Guatapará;2013;0;0;0;0;0;0
3518859;Guatapará;2014;0;0;0;0;0;0
3518859;Guatapará;2015;0;0;0;0;0;0
3518859;Guatapará;2016;0;0;0;0;0;0
3518859;Guatapará;2017;0;0;0;0;0;0
3518859;Guatapará;2018;0;0;0;0;0;0
3518859;Guatapará;2019;0;0;0;0;0;0
3518909;Guzolândia;2010;0;0;0;0;0;0
3518909;Guzolândia;2011;0;0;0;0;0;0
3518909;Guzolândia;2012;0;0;0;0;0;0
3518909;Guzolândia;2013;0;0;0;0;0;0
3518909;Guzolândia;2014;0;0;0;0;0;0
3518909;Guzolândia;2015;0;0;0;0;0;0
3518909;Guzolândia;2016;0;0;0;0;0;0
3518909;Guzolândia;2017;0;0;0;0;0;0
3518909;Guzolândia;2018;0;0;0;0;0;0
3518909;Guzolândia;2019;0;0;0;0;0;0
3519006;Herculândia;2010;23;2,65;19;2,19;4;0,46
3519006;Herculândia;2011;32;3,66;19;2,17;13;1,49
3519006;Herculândia;2012;32;3,63;19;2,16;13;1,48
3519006;Herculândia;2013;32;3,61;32;3,61;0;0
3519006;Herculândia;2014;32;3,59;32;3,59;0;0
3519006;Herculândia;2015;51;5,68;51;5,68;0;0
3519006;Herculândia;2016;58;6,42;58;6,42;0;0
3519006;Herculândia;2017;58;6,38;58;6,38;0;0
3519006;Herculândia;2018;58;6,34;58;6,34;0;0
3519006;Herculândia;2019;58;6,3;58;6,3;0;0
3519055;Holambra;2010;0;0;0;0;0;0
3519055;Holambra;2011;0;0;0;0;0;0
3519055;Holambra;2012;0;0;0;0;0;0
3519055;Holambra;2013;0;0;0;0;0;0
3519055;Holambra;2014;0;0;0;0;0;0
3519055;Holambra;2015;0;0;0;0;0;0
3519055;Holambra;2016;0;0;0;0;0;0
3519055;Holambra;2017;0;0;0;0;0;0
3519055;Holambra;2018;0;0;0;0;0;0
3519055;Holambra;2019;0;0;0;0;0;0
3519071;Hortolândia;2010;75;0,39;68;0,35;7;0,04
3519071;Hortolândia;2011;72;0,37;65;0,33;7;0,04
3519071;Hortolândia;2012;94;0,47;65;0,33;29;0,15
3519071;Hortolândia;2013;91;0,45;62;0,3;29;0,14
3519071;Hortolândia;2014;91;0,44;62;0,3;29;0,14
3519071;Hortolândia;2015;91;0,43;62;0,29;29;0,14
3519071;Hortolândia;2016;91;0,42;62;0,29;29;0,13
3519071;Hortolândia;2017;91;0,42;62;0,28;29;0,13
3519071;Hortolândia;2018;84;0,38;62;0,28;22;0,1
3519071;Hortolândia;2019;100;0,44;78;0,34;22;0,1
3519105;Iacanga;2010;27;2,7;25;2,5;2;0,2
3519105;Iacanga;2011;27;2,66;25;2,47;2;0,2
3519105;Iacanga;2012;27;2,63;25;2,43;2;0,19
3519105;Iacanga;2013;27;2,59;25;2,4;2;0,19
3519105;Iacanga;2014;27;2,56;25;2,37;2;0,19
3519105;Iacanga;2015;27;2,52;25;2,34;2;0,19
3519105;Iacanga;2016;27;2,5;25;2,31;2;0,18
3519105;Iacanga;2017;30;2,74;28;2,56;2;0,18
3519105;Iacanga;2018;30;2,71;28;2,53;2;0,18
3519105;Iacanga;2019;30;2,68;28;2,5;2;0,18
3519204;Iacri;2010;15;2,34;15;2,34;0;0
3519204;Iacri;2011;15;2,34;15;2,34;0;0
3519204;Iacri;2012;15;2,35;15;2,35;0;0
3519204;Iacri;2013;19;2,98;15;2,35;4;0,63
3519204;Iacri;2014;19;2,98;15;2,36;4;0,63
3519204;Iacri;2015;19;2,99;15;2,36;4;0,63
3519204;Iacri;2016;19;3;15;2,37;4;0,63
3519204;Iacri;2017;0;0;0;0;0;0
3519204;Iacri;2018;0;0;0;0;0;0
3519204;Iacri;2019;0;0;0;0;0;0
3519253;Iaras;2010;0;0;0;0;0;0
3519253;Iaras;2011;0;0;0;0;0;0
3519253;Iaras;2012;0;0;0;0;0;0
3519253;Iaras;2013;0;0;0;0;0;0
3519253;Iaras;2014;0;0;0;0;0;0
3519253;Iaras;2015;0;0;0;0;0;0
3519253;Iaras;2016;0;0;0;0;0;0
3519253;Iaras;2017;0;0;0;0;0;0
3519253;Iaras;2018;0;0;0;0;0;0
3519253;Iaras;2019;0;0;0;0;0;0
3519303;Ibaté;2010;67;2,18;62;2,02;5;0,16
3519303;Ibaté;2011;23;0,74;23;0,74;0;0
3519303;Ibaté;2012;32;1,02;32;1,02;0;0
3519303;Ibaté;2013;32;1;32;1;0;0
3519303;Ibaté;2014;32;0,99;32;0,99;0;0
3519303;Ibaté;2015;32;0,98;32;0,98;0;0
3519303;Ibaté;2016;32;0,96;32;0,96;0;0
3519303;Ibaté;2017;32;0,95;32;0,95;0;0
3519303;Ibaté;2018;32;0,94;32;0,94;0;0
3519303;Ibaté;2019;27;0,79;27;0,79;0;0
3519402;Ibirá;2010;27;2,48;9;0,83;18;1,65
3519402;Ibirá;2011;27;2,45;9;0,82;18;1,64
3519402;Ibirá;2012;27;2,43;9;0,81;18;1,62
3519402;Ibirá;2013;27;2,4;9;0,8;18;1,6
3519402;Ibirá;2014;27;2,37;8;0,7;19;1,67
3519402;Ibirá;2015;25;2,17;8;0,69;17;1,48
3519402;Ibirá;2016;25;2,15;8;0,69;17;1,46
3519402;Ibirá;2017;27;2,3;10;0,85;17;1,45
3519402;Ibirá;2018;27;2,28;9;0,76;18;1,52
3519402;Ibirá;2019;27;2,26;9;0,75;18;1,51
3519501;Ibirarema;2010;0;0;0;0;0;0
3519501;Ibirarema;2011;0;0;0;0;0;0
3519501;Ibirarema;2012;0;0;0;0;0;0
3519501;Ibirarema;2013;0;0;0;0;0;0
3519501;Ibirarema;2014;0;0;0;0;0;0
3519501;Ibirarema;2015;0;0;0;0;0;0
3519501;Ibirarema;2016;0;0;0;0;0;0
3519501;Ibirarema;2017;0;0;0;0;0;0
3519501;Ibirarema;2018;0;0;0;0;0;0
3519501;Ibirarema;2019;0;0;0;0;0;0
3519600;Ibitinga;2010;93;1,75;52;0,98;41;0,77
3519600;Ibitinga;2011;93;1,73;52;0,97;41;0,76
3519600;Ibitinga;2012;93;1,71;52;0,96;41;0,76
3519600;Ibitinga;2013;99;1,8;52;0,95;47;0,86
3519600;Ibitinga;2014;99;1,79;46;0,83;53;0,96
3519600;Ibitinga;2015;99;1,77;46;0,82;53;0,95
3519600;Ibitinga;2016;99;1,75;46;0,81;53;0,94
3519600;Ibitinga;2017;99;1,74;52;0,91;47;0,82
3519600;Ibitinga;2018;99;1,72;46;0,8;53;0,92
3519600;Ibitinga;2019;103;1,78;46;0,79;57;0,98
3519709;Ibiúna;2010;16;0,22;16;0,22;0;0
3519709;Ibiúna;2011;32;0,45;32;0,45;0;0
3519709;Ibiúna;2012;63;0,87;63;0,87;0;0
3519709;Ibiúna;2013;67;0,92;63;0,87;4;0,05
3519709;Ibiúna;2014;67;0,91;63;0,86;4;0,05
3519709;Ibiúna;2015;67;0,91;63;0,85;4;0,05
3519709;Ibiúna;2016;67;0,9;63;0,85;4;0,05
3519709;Ibiúna;2017;67;0,89;63;0,84;4;0,05
3519709;Ibiúna;2018;67;0,89;63;0,84;4;0,05
3519709;Ibiúna;2019;172;2,27;63;0,83;109;1,44
3519808;Icém;2010;0;0;0;0;0;0
3519808;Icém;2011;0;0;0;0;0;0
3519808;Icém;2012;0;0;0;0;0;0
3519808;Icém;2013;0;0;0;0;0;0
3519808;Icém;2014;0;0;0;0;0;0
3519808;Icém;2015;0;0;0;0;0;0
3519808;Icém;2016;0;0;0;0;0;0
3519808;Icém;2017;0;0;0;0;0;0
3519808;Icém;2018;0;0;0;0;0;0
3519808;Icém;2019;0;0;0;0;0;0
3519907;Iepê;2010;20;2,62;20;2,62;0;0
3519907;Iepê;2011;20;2,61;20;2,61;0;0
3519907;Iepê;2012;20;2,6;20;2,6;0;0
3519907;Iepê;2013;20;2,59;20;2,59;0;0
3519907;Iepê;2014;20;2,58;20;2,58;0;0
3519907;Iepê;2015;20;2,57;20;2,57;0;0
3519907;Iepê;2016;20;2,56;20;2,56;0;0
3519907;Iepê;2017;20;2,55;20;2,55;0;0
3519907;Iepê;2018;20;2,54;20;2,54;0;0
3519907;Iepê;2019;18;2,28;18;2,28;0;0
3520103;Igarapava;2010;50;1,79;32;1,15;18;0,64
3520103;Igarapava;2011;50;1,78;32;1,14;18;0,64
3520103;Igarapava;2012;50;1,77;32;1,13;18;0,64
3520103;Igarapava;2013;50;1,76;32;1,13;18;0,63
3520103;Igarapava;2014;50;1,75;32;1,12;18;0,63
3520103;Igarapava;2015;60;2,09;32;1,11;28;0,97
3520103;Igarapava;2016;60;2,08;32;1,11;28;0,97
3520103;Igarapava;2017;60;2,07;32;1,1;28;0,96
3520103;Igarapava;2018;60;2,06;42;1,44;18;0,62
3520103;Igarapava;2019;60;2,05;42;1,43;18;0,61
3520202;Igaratá;2010;15;1,7;15;1,7;0;0
3520202;Igaratá;2011;15;1,69;15;1,69;0;0
3520202;Igaratá;2012;15;1,68;15;1,68;0;0
3520202;Igaratá;2013;15;1,67;15;1,67;0;0
3520202;Igaratá;2014;15;1,66;15;1,66;0;0
3520202;Igaratá;2015;15;1,65;15;1,65;0;0
3520202;Igaratá;2016;15;1,64;15;1,64;0;0
3520202;Igaratá;2017;15;1,64;15;1,64;0;0
3520202;Igaratá;2018;15;1,63;15;1,63;0;0
3520202;Igaratá;2019;8;0,86;8;0,86;0;0
3520004;Igaraçu do Tietê;2010;67;2,87;67;2,87;0;0
3520004;Igaraçu do Tietê;2011;63;2,69;55;2,35;8;0,34
3520004;Igaraçu do Tietê;2012;63;2,68;55;2,34;8;0,34
3520004;Igaraçu do Tietê;2013;63;2,67;55;2,33;8;0,34
3520004;Igaraçu do Tietê;2014;63;2,66;55;2,32;8;0,34
3520004;Igaraçu do Tietê;2015;63;2,65;55;2,32;8;0,34
3520004;Igaraçu do Tietê;2016;63;2,65;0;0;63;2,65
3520004;Igaraçu do Tietê;2017;63;2,64;0;0;63;2,64
3520004;Igaraçu do Tietê;2018;63;2,63;0;0;63;2,63
3520004;Igaraçu do Tietê;2019;0;0;0;0;0;0
3520301;Iguape;2010;34;1,18;34;1,18;0;0
3520301;Iguape;2011;34;1,18;34;1,18;0;0
3520301;Iguape;2012;13;0,45;13;0,45;0;0
3520301;Iguape;2013;13;0,45;13;0,45;0;0
3520301;Iguape;2014;13;0,45;13;0,45;0;0
3520301;Iguape;2015;13;0,45;13;0,45;0;0
3520301;Iguape;2016;13;0,45;13;0,45;0;0
3520301;Iguape;2017;9;0,31;9;0,31;0;0
3520301;Iguape;2018;9;0,31;9;0,31;0;0
3520301;Iguape;2019;9;0,31;9;0,31;0;0
3520426;Ilha Comprida;2010;0;0;0;0;0;0
3520426;Ilha Comprida;2011;0;0;0;0;0;0
3520426;Ilha Comprida;2012;0;0;0;0;0;0
3520426;Ilha Comprida;2013;0;0;0;0;0;0
3520426;Ilha Comprida;2014;0;0;0;0;0;0
3520426;Ilha Comprida;2015;0;0;0;0;0;0
3520426;Ilha Comprida;2016;0;0;0;0;0;0
3520426;Ilha Comprida;2017;0;0;0;0;0;0
3520426;Ilha Comprida;2018;0;0;0;0;0;0
3520426;Ilha Comprida;2019;0;0;0;0;0;0
3520442;Ilha Solteira;2010;116;4,63;74;2,95;42;1,68
3520442;Ilha Solteira;2011;116;4,61;74;2,94;42;1,67
3520442;Ilha Solteira;2012;116;4,6;74;2,93;42;1,66
3520442;Ilha Solteira;2013;116;4,58;74;2,92;42;1,66
3520442;Ilha Solteira;2014;116;4,57;74;2,91;42;1,65
3520442;Ilha Solteira;2015;116;4,55;74;2,9;42;1,65
3520442;Ilha Solteira;2016;116;4,54;74;2,9;42;1,64
3520442;Ilha Solteira;2017;116;4,53;74;2,89;42;1,64
3520442;Ilha Solteira;2018;116;4,52;74;2,89;42;1,64
3520442;Ilha Solteira;2019;116;4,51;74;2,88;42;1,63
3520400;Ilhabela;2010;40;1,42;37;1,32;3;0,11
3520400;Ilhabela;2011;40;1,39;37;1,29;3;0,1
3520400;Ilhabela;2012;40;1,37;37;1,26;3;0,1
3520400;Ilhabela;2013;40;1,34;37;1,24;3;0,1
3520400;Ilhabela;2014;40;1,31;37;1,22;3;0,1
3520400;Ilhabela;2015;49;1,58;46;1,48;3;0,1
3520400;Ilhabela;2016;49;1,56;46;1,46;3;0,1
3520400;Ilhabela;2017;49;1,53;46;1,44;3;0,09
3520400;Ilhabela;2018;46;1,42;46;1,42;0;0
3520400;Ilhabela;2019;51;1,55;51;1,55;0;0
3520509;Indaiatuba;2010;318;1,58;211;1,05;107;0,53
3520509;Indaiatuba;2011;326;1,58;230;1,12;96;0,47
3520509;Indaiatuba;2012;346;1,64;258;1,22;88;0,42
3520509;Indaiatuba;2013;367;1,7;258;1,2;109;0,51
3520509;Indaiatuba;2014;372;1,69;268;1,21;104;0,47
3520509;Indaiatuba;2015;378;1,67;268;1,19;110;0,49
3520509;Indaiatuba;2016;342;1,49;232;1,01;110;0,48
3520509;Indaiatuba;2017;362;1,56;232;1;130;0,56
3520509;Indaiatuba;2018;337;1,43;207;0,88;130;0,55
3520509;Indaiatuba;2019;350;1,46;207;0,86;143;0,6
3520608;Indiana;2010;0;0;0;0;0;0
3520608;Indiana;2011;0;0;0;0;0;0
3520608;Indiana;2012;0;0;0;0;0;0
3520608;Indiana;2013;0;0;0;0;0;0
3520608;Indiana;2014;0;0;0;0;0;0
3520608;Indiana;2015;0;0;0;0;0;0
3520608;Indiana;2016;0;0;0;0;0;0
3520608;Indiana;2017;0;0;0;0;0;0
3520608;Indiana;2018;0;0;0;0;0;0
3520608;Indiana;2019;0;0;0;0;0;0
3520707;Indiaporã;2010;40;10,25;5;1,28;35;8,97
3520707;Indiaporã;2011;40;10,26;5;1,28;35;8,98
3520707;Indiaporã;2012;40;10,28;5;1,29;35;9
3520707;Indiaporã;2013;40;10,3;5;1,29;35;9,01
3520707;Indiaporã;2014;40;10,32;5;1,29;35;9,03
3520707;Indiaporã;2015;46;11,89;4;1,03;42;10,86
3520707;Indiaporã;2016;36;9,31;4;1,03;32;8,28
3520707;Indiaporã;2017;36;9,32;4;1,04;32;8,28
3520707;Indiaporã;2018;36;9,33;4;1,04;32;8,29
3520707;Indiaporã;2019;36;9,33;4;1,04;32;8,3
3520806;Inúbia Paulista;2010;0;0;0;0;0;0
3520806;Inúbia Paulista;2011;0;0;0;0;0;0
3520806;Inúbia Paulista;2012;0;0;0;0;0;0
3520806;Inúbia Paulista;2013;0;0;0;0;0;0
3520806;Inúbia Paulista;2014;0;0;0;0;0;0
3520806;Inúbia Paulista;2015;0;0;0;0;0;0
3520806;Inúbia Paulista;2016;0;0;0;0;0;0
3520806;Inúbia Paulista;2017;0;0;0;0;0;0
3520806;Inúbia Paulista;2018;0;0;0;0;0;0
3520806;Inúbia Paulista;2019;0;0;0;0;0;0
3520905;Ipaussu;2010;49;3,59;21;1,54;28;2,05
3520905;Ipaussu;2011;49;3,57;21;1,53;28;2,04
3520905;Ipaussu;2012;49;3,55;21;1,52;28;2,03
3520905;Ipaussu;2013;49;3,52;29;2,09;20;1,44
3520905;Ipaussu;2014;49;3,5;29;2,07;20;1,43
3520905;Ipaussu;2015;49;3,48;29;2,06;20;1,42
3520905;Ipaussu;2016;49;3,46;29;2,05;20;1,41
3520905;Ipaussu;2017;49;3,44;29;2,04;20;1,4
3520905;Ipaussu;2018;49;3,42;29;2,02;20;1,4
3520905;Ipaussu;2019;49;3,4;29;2,01;20;1,39
3521002;Iperó;2010;0;0;0;0;0;0
3521002;Iperó;2011;0;0;0;0;0;0
3521002;Iperó;2012;15;0,51;15;0,51;0;0
3521002;Iperó;2013;15;0,5;15;0,5;0;0
3521002;Iperó;2014;15;0,49;15;0,49;0;0
3521002;Iperó;2015;15;0,48;15;0,48;0;0
3521002;Iperó;2016;15;0,47;15;0,47;0;0
3521002;Iperó;2017;15;0,46;15;0,46;0;0
3521002;Iperó;2018;15;0,45;15;0,45;0;0
3521002;Iperó;2019;15;0,44;15;0,44;0;0
3521101;Ipeúna;2010;0;0;0;0;0;0
3521101;Ipeúna;2011;0;0;0;0;0;0
3521101;Ipeúna;2012;0;0;0;0;0;0
3521101;Ipeúna;2013;0;0;0;0;0;0
3521101;Ipeúna;2014;0;0;0;0;0;0
3521101;Ipeúna;2015;0;0;0;0;0;0
3521101;Ipeúna;2016;0;0;0;0;0;0
3521101;Ipeúna;2017;0;0;0;0;0;0
3521101;Ipeúna;2018;0;0;0;0;0;0
3521101;Ipeúna;2019;0;0;0;0;0;0
3521150;Ipiguá;2010;0;0;0;0;0;0
3521150;Ipiguá;2011;0;0;0;0;0;0
3521150;Ipiguá;2012;0;0;0;0;0;0
3521150;Ipiguá;2013;0;0;0;0;0;0
3521150;Ipiguá;2014;0;0;0;0;0;0
3521150;Ipiguá;2015;0;0;0;0;0;0
3521150;Ipiguá;2016;0;0;0;0;0;0
3521150;Ipiguá;2017;0;0;0;0;0;0
3521150;Ipiguá;2018;0;0;0;0;0;0
3521150;Ipiguá;2019;0;0;0;0;0;0
3521200;Iporanga;2010;0;0;0;0;0;0
3521200;Iporanga;2011;0;0;0;0;0;0
3521200;Iporanga;2012;0;0;0;0;0;0
3521200;Iporanga;2013;0;0;0;0;0;0
3521200;Iporanga;2014;0;0;0;0;0;0
3521200;Iporanga;2015;0;0;0;0;0;0
3521200;Iporanga;2016;0;0;0;0;0;0
3521200;Iporanga;2017;0;0;0;0;0;0
3521200;Iporanga;2018;0;0;0;0;0;0
3521200;Iporanga;2019;0;0;0;0;0;0
3521309;Ipuã;2010;48;3,4;28;1,98;20;1,42
3521309;Ipuã;2011;48;3,36;28;1,96;20;1,4
3521309;Ipuã;2012;48;3,31;28;1,93;20;1,38
3521309;Ipuã;2013;49;3,34;40;2,73;9;0,61
3521309;Ipuã;2014;49;3,3;39;2,63;10;0,67
3521309;Ipuã;2015;49;3,26;39;2,59;10;0,67
3521309;Ipuã;2016;49;3,22;39;2,57;10;0,66
3521309;Ipuã;2017;49;3,19;39;2,54;10;0,65
3521309;Ipuã;2018;49;3,16;39;2,51;10;0,64
3521309;Ipuã;2019;49;3,12;39;2,49;10;0,64
3521408;Iracemápolis;2010;0;0;0;0;0;0
3521408;Iracemápolis;2011;0;0;0;0;0;0
3521408;Iracemápolis;2012;0;0;0;0;0;0
3521408;Iracemápolis;2013;0;0;0;0;0;0
3521408;Iracemápolis;2014;0;0;0;0;0;0
3521408;Iracemápolis;2015;0;0;0;0;0;0
3521408;Iracemápolis;2016;0;0;0;0;0;0
3521408;Iracemápolis;2017;0;0;0;0;0;0
3521408;Iracemápolis;2018;2;0,09;2;0,09;0;0
3521408;Iracemápolis;2019;3;0,13;3;0,13;0;0
3521507;Irapuã;2010;0;0;0;0;0;0
3521507;Irapuã;2011;0;0;0;0;0;0
3521507;Irapuã;2012;0;0;0;0;0;0
3521507;Irapuã;2013;0;0;0;0;0;0
3521507;Irapuã;2014;0;0;0;0;0;0
3521507;Irapuã;2015;0;0;0;0;0;0
3521507;Irapuã;2016;0;0;0;0;0;0
3521507;Irapuã;2017;0;0;0;0;0;0
3521507;Irapuã;2018;0;0;0;0;0;0
3521507;Irapuã;2019;0;0;0;0;0;0
3521606;Irapuru;2010;0;0;0;0;0;0
3521606;Irapuru;2011;0;0;0;0;0;0
3521606;Irapuru;2012;0;0;0;0;0;0
3521606;Irapuru;2013;0;0;0;0;0;0
3521606;Irapuru;2014;0;0;0;0;0;0
3521606;Irapuru;2015;0;0;0;0;0;0
3521606;Irapuru;2016;0;0;0;0;0;0
3521606;Irapuru;2017;0;0;0;0;0;0
3521606;Irapuru;2018;0;0;0;0;0;0
3521606;Irapuru;2019;0;0;0;0;0;0
3521705;Itaberá;2010;35;1,96;30;1,68;5;0,28
3521705;Itaberá;2011;35;1,96;30;1,68;5;0,28
3521705;Itaberá;2012;35;1,97;30;1,69;5;0,28
3521705;Itaberá;2013;35;1,97;30;1,69;5;0,28
3521705;Itaberá;2014;70;3,95;65;3,67;5;0,28
3521705;Itaberá;2015;35;1,98;35;1,98;0;0
3521705;Itaberá;2016;35;1,98;35;1,98;0;0
3521705;Itaberá;2017;35;1,98;35;1,98;0;0
3521705;Itaberá;2018;35;1,98;35;1,98;0;0
3521705;Itaberá;2019;19;1,08;19;1,08;0;0
3521804;Itaí;2010;40;1,67;40;1,67;0;0
3521804;Itaí;2011;41;1,69;40;1,65;1;0,04
3521804;Itaí;2012;41;1,67;40;1,63;1;0,04
3521804;Itaí;2013;41;1,66;40;1,62;1;0,04
3521804;Itaí;2014;41;1,64;40;1,6;1;0,04
3521804;Itaí;2015;39;1,54;36;1,43;3;0,12
3521804;Itaí;2016;39;1,53;36;1,41;3;0,12
3521804;Itaí;2017;35;1,36;35;1,36;0;0
3521804;Itaí;2018;35;1,35;35;1,35;0;0
3521804;Itaí;2019;35;1,33;35;1,33;0;0
3521903;Itajobi;2010;36;2,47;15;1,03;21;1,44
3521903;Itajobi;2011;36;2,47;15;1,03;21;1,44
3521903;Itajobi;2012;36;2,47;15;1,03;21;1,44
3521903;Itajobi;2013;30;2,06;13;0,89;17;1,16
3521903;Itajobi;2014;30;2,05;13;0,89;17;1,16
3521903;Itajobi;2015;30;2,05;13;0,89;17;1,16
3521903;Itajobi;2016;27;1,85;15;1,03;12;0,82
3521903;Itajobi;2017;30;2,05;20;1,37;10;0,68
3521903;Itajobi;2018;30;2,05;20;1,37;10;0,68
3521903;Itajobi;2019;50;3,42;32;2,19;18;1,23
3522000;Itaju;2010;0;0;0;0;0;0
3522000;Itaju;2011;0;0;0;0;0;0
3522000;Itaju;2012;0;0;0;0;0;0
3522000;Itaju;2013;0;0;0;0;0;0
3522000;Itaju;2014;0;0;0;0;0;0
3522000;Itaju;2015;0;0;0;0;0;0
3522000;Itaju;2016;0;0;0;0;0;0
3522000;Itaju;2017;0;0;0;0;0;0
3522000;Itaju;2018;0;0;0;0;0;0
3522000;Itaju;2019;0;0;0;0;0;0
3522109;Itanhaém;2010;71;0,82;71;0,82;0;0
3522109;Itanhaém;2011;77;0,87;77;0,87;0;0
3522109;Itanhaém;2012;77;0,86;77;0,86;0;0
3522109;Itanhaém;2013;74;0,82;74;0,82;0;0
3522109;Itanhaém;2014;74;0,81;74;0,81;0;0
3522109;Itanhaém;2015;77;0,83;77;0,83;0;0
3522109;Itanhaém;2016;77;0,82;77;0,82;0;0
3522109;Itanhaém;2017;77;0,81;77;0,81;0;0
3522109;Itanhaém;2018;131;1,36;131;1,36;0;0
3522109;Itanhaém;2019;131;1,34;131;1,34;0;0
3522158;Itaoca;2010;0;0;0;0;0;0
3522158;Itaoca;2011;0;0;0;0;0;0
3522158;Itaoca;2012;0;0;0;0;0;0
3522158;Itaoca;2013;0;0;0;0;0;0
3522158;Itaoca;2014;0;0;0;0;0;0
3522158;Itaoca;2015;0;0;0;0;0;0
3522158;Itaoca;2016;0;0;0;0;0;0
3522158;Itaoca;2017;0;0;0;0;0;0
3522158;Itaoca;2018;0;0;0;0;0;0
3522158;Itaoca;2019;0;0;0;0;0;0
3522208;Itapecerica da Serra;2010;472;3,1;282;1,85;190;1,25
3522208;Itapecerica da Serra;2011;472;3,06;282;1,83;190;1,23
3522208;Itapecerica da Serra;2012;472;3,03;282;1,81;190;1,22
3522208;Itapecerica da Serra;2013;446;2,83;281;1,78;165;1,05
3522208;Itapecerica da Serra;2014;444;2,78;197;1,24;247;1,55
3522208;Itapecerica da Serra;2015;501;3,11;196;1,22;305;1,89
3522208;Itapecerica da Serra;2016;501;3,08;176;1,08;325;2
3522208;Itapecerica da Serra;2017;501;3,04;176;1,07;325;1,97
3522208;Itapecerica da Serra;2018;583;3,51;176;1,06;407;2,45
3522208;Itapecerica da Serra;2019;583;3,47;176;1,05;407;2,42
3522307;Itapetininga;2010;127;0,88;79;0,55;48;0,33
3522307;Itapetininga;2011;129;0,88;93;0,64;36;0,25
3522307;Itapetininga;2012;129;0,88;93;0,63;36;0,24
3522307;Itapetininga;2013;129;0,87;107;0,72;22;0,15
3522307;Itapetininga;2014;129;0,86;107;0,71;22;0,15
3522307;Itapetininga;2015;122;0,8;100;0,66;22;0,14
3522307;Itapetininga;2016;122;0,79;100;0,65;22;0,14
3522307;Itapetininga;2017;122;0,79;100;0,64;22;0,14
3522307;Itapetininga;2018;142;0,9;100;0,64;42;0,27
3522307;Itapetininga;2019;142;0,9;100;0,63;42;0,26
3522406;Itapeva;2010;204;2,33;153;1,74;51;0,58
3522406;Itapeva;2011;204;2,32;153;1,74;51;0,58
3522406;Itapeva;2012;195;2,2;141;1,59;54;0,61
3522406;Itapeva;2013;192;2,16;150;1,69;42;0,47
3522406;Itapeva;2014;164;1,84;122;1,37;42;0,47
3522406;Itapeva;2015;164;1,83;122;1,36;42;0,47
3522406;Itapeva;2016;159;1,77;117;1,3;42;0,47
3522406;Itapeva;2017;145;1,6;103;1,14;42;0,46
3522406;Itapeva;2018;145;1,6;103;1,13;42;0,46
3522406;Itapeva;2019;134;1,47;93;1,02;41;0,45
3522505;Itapevi;2010;246;1,23;216;1,08;30;0,15
3522505;Itapevi;2011;254;1,25;205;1,01;49;0,24
3522505;Itapevi;2012;254;1,22;205;0,99;49;0,24
3522505;Itapevi;2013;254;1,2;205;0,97;49;0,23
3522505;Itapevi;2014;269;1,25;205;0,95;64;0,3
3522505;Itapevi;2015;265;1,21;205;0,94;60;0,27
3522505;Itapevi;2016;286;1,29;205;0,92;81;0,36
3522505;Itapevi;2017;306;1,35;217;0,96;89;0,39
3522505;Itapevi;2018;294;1,28;217;0,94;77;0,33
3522505;Itapevi;2019;307;1,31;213;0,91;94;0,4
3522604;Itapira;2010;1448;21,14;855;12,48;593;8,66
3522604;Itapira;2011;1452;21,09;839;12,18;613;8,9
3522604;Itapira;2012;1377;19,89;838;12,11;539;7,79
3522604;Itapira;2013;1377;19,79;838;12,04;539;7,74
3522604;Itapira;2014;1276;18,24;737;10,53;539;7,7
3522604;Itapira;2015;1284;18,25;749;10,65;535;7,61
3522604;Itapira;2016;1046;14,82;587;8,32;459;6,5
3522604;Itapira;2017;1041;14,7;578;8,16;463;6,54
3522604;Itapira;2018;1041;14,65;578;8,14;463;6,52
3522604;Itapira;2019;988;13,86;576;8,08;412;5,78
3522653;Itapirapuã Paulista;2010;0;0;0;0;0;0
3522653;Itapirapuã Paulista;2011;0;0;0;0;0;0
3522653;Itapirapuã Paulista;2012;0;0;0;0;0;0
3522653;Itapirapuã Paulista;2013;0;0;0;0;0;0
3522653;Itapirapuã Paulista;2014;0;0;0;0;0;0
3522653;Itapirapuã Paulista;2015;0;0;0;0;0;0
3522653;Itapirapuã Paulista;2016;0;0;0;0;0;0
3522653;Itapirapuã Paulista;2017;0;0;0;0;0;0
3522653;Itapirapuã Paulista;2018;0;0;0;0;0;0
3522653;Itapirapuã Paulista;2019;0;0;0;0;0;0
3522703;Itápolis;2010;74;1,85;43;1,07;31;0,77
3522703;Itápolis;2011;74;1,84;46;1,14;28;0,7
3522703;Itápolis;2012;73;1,81;45;1,12;28;0,69
3522703;Itápolis;2013;76;1,88;45;1,11;31;0,77
3522703;Itápolis;2014;76;1,87;45;1,11;31;0,76
3522703;Itápolis;2015;76;1,86;45;1,1;31;0,76
3522703;Itápolis;2016;76;1,85;46;1,12;30;0,73
3522703;Itápolis;2017;76;1,85;46;1,12;30;0,73
3522703;Itápolis;2018;76;1,84;46;1,11;30;0,73
3522703;Itápolis;2019;76;1,84;46;1,11;30;0,72
3522802;Itaporanga;2010;49;3,37;33;2,27;16;1,1
3522802;Itaporanga;2011;49;3,37;33;2,27;16;1,1
3522802;Itaporanga;2012;49;3,36;33;2,27;16;1,1
3522802;Itaporanga;2013;49;3,36;33;2,26;16;1,1
3522802;Itaporanga;2014;46;3,15;27;1,85;19;1,3
3522802;Itaporanga;2015;46;3,15;27;1,85;19;1,3
3522802;Itaporanga;2016;46;3,15;27;1,85;19;1,3
3522802;Itaporanga;2017;46;3,14;27;1,84;19;1,3
3522802;Itaporanga;2018;46;3,14;27;1,84;19;1,3
3522802;Itaporanga;2019;46;3,14;27;1,84;19;1,3
3522901;Itapuí;2010;33;2,71;22;1,81;11;0,9
3522901;Itapuí;2011;33;2,68;22;1,79;11;0,89
3522901;Itapuí;2012;33;2,64;22;1,76;11;0,88
3522901;Itapuí;2013;33;2,61;22;1,74;11;0,87
3522901;Itapuí;2014;33;2,57;22;1,71;11;0,86
3522901;Itapuí;2015;40;3,07;33;2,54;7;0,54
3522901;Itapuí;2016;30;2,28;25;1,9;5;0,38
3522901;Itapuí;2017;30;2,25;25;1,88;5;0,38
3522901;Itapuí;2018;30;2,23;25;1,86;5;0,37
3522901;Itapuí;2019;30;2,2;30;2,2;0;0
3523008;Itapura;2010;0;0;0;0;0;0
3523008;Itapura;2011;0;0;0;0;0;0
3523008;Itapura;2012;0;0;0;0;0;0
3523008;Itapura;2013;0;0;0;0;0;0
3523008;Itapura;2014;0;0;0;0;0;0
3523008;Itapura;2015;0;0;0;0;0;0
3523008;Itapura;2016;0;0;0;0;0;0
3523008;Itapura;2017;0;0;0;0;0;0
3523008;Itapura;2018;0;0;0;0;0;0
3523008;Itapura;2019;0;0;0;0;0;0
3523107;Itaquaquecetuba;2010;254;0,79;224;0,7;30;0,09
3523107;Itaquaquecetuba;2011;254;0,78;224;0,69;30;0,09
3523107;Itaquaquecetuba;2012;254;0,77;224;0,68;30;0,09
3523107;Itaquaquecetuba;2013;224;0,67;224;0,67;0;0
3523107;Itaquaquecetuba;2014;224;0,66;224;0,66;0;0
3523107;Itaquaquecetuba;2015;224;0,65;224;0,65;0;0
3523107;Itaquaquecetuba;2016;224;0,64;224;0,64;0;0
3523107;Itaquaquecetuba;2017;224;0,63;224;0,63;0;0
3523107;Itaquaquecetuba;2018;224;0,62;224;0,62;0;0
3523107;Itaquaquecetuba;2019;224;0,61;224;0,61;0;0
3523206;Itararé;2010;97;2,02;73;1,52;24;0,5
3523206;Itararé;2011;97;2,02;73;1,52;24;0,5
3523206;Itararé;2012;97;2,02;80;1,66;17;0,35
3523206;Itararé;2013;98;2,03;82;1,7;16;0,33
3523206;Itararé;2014;93;1,93;78;1,62;15;0,31
3523206;Itararé;2015;93;1,92;78;1,61;15;0,31
3523206;Itararé;2016;97;2;82;1,69;15;0,31
3523206;Itararé;2017;96;1,97;78;1,6;18;0,37
3523206;Itararé;2018;96;1,97;78;1,6;18;0,37
3523206;Itararé;2019;80;1,64;64;1,31;16;0,33
3523305;Itariri;2010;0;0;0;0;0;0
3523305;Itariri;2011;0;0;0;0;0;0
3523305;Itariri;2012;0;0;0;0;0;0
3523305;Itariri;2013;0;0;0;0;0;0
3523305;Itariri;2014;0;0;0;0;0;0
3523305;Itariri;2015;0;0;0;0;0;0
3523305;Itariri;2016;0;0;0;0;0;0
3523305;Itariri;2017;0;0;0;0;0;0
3523305;Itariri;2018;0;0;0;0;0;0
3523305;Itariri;2019;0;0;0;0;0;0
3523404;Itatiba;2010;102;1,01;57;0,56;45;0,44
3523404;Itatiba;2011;112;1,09;60;0,58;52;0,5
3523404;Itatiba;2012;112;1,07;60;0,57;52;0,5
3523404;Itatiba;2013;112;1,05;60;0,56;52;0,49
3523404;Itatiba;2014;112;1,03;60;0,55;52;0,48
3523404;Itatiba;2015;119;1,08;60;0,54;59;0,53
3523404;Itatiba;2016;119;1,06;60;0,54;59;0,53
3523404;Itatiba;2017;119;1,05;60;0,53;59;0,52
3523404;Itatiba;2018;119;1,04;60;0,52;59;0,51
3523404;Itatiba;2019;119;1,02;69;0,59;50;0,43
3523503;Itatinga;2010;14;0,78;7;0,39;7;0,39
3523503;Itatinga;2011;14;0,77;7;0,38;7;0,38
3523503;Itatinga;2012;14;0,76;7;0,38;7;0,38
3523503;Itatinga;2013;14;0,75;7;0,37;7;0,37
3523503;Itatinga;2014;14;0,74;7;0,37;7;0,37
3523503;Itatinga;2015;14;0,73;7;0,36;7;0,36
3523503;Itatinga;2016;14;0,72;7;0,36;7;0,36
3523503;Itatinga;2017;14;0,71;7;0,35;7;0,35
3523503;Itatinga;2018;14;0,7;7;0,35;7;0,35
3523503;Itatinga;2019;14;0,69;7;0,34;7;0,34
3523602;Itirapina;2010;24;1,55;20;1,29;4;0,26
3523602;Itirapina;2011;24;1,53;20;1,28;4;0,26
3523602;Itirapina;2012;24;1,51;20;1,26;4;0,25
3523602;Itirapina;2013;24;1,5;20;1,25;4;0,25
3523602;Itirapina;2014;8;0,49;8;0,49;0;0
3523602;Itirapina;2015;8;0,49;8;0,49;0;0
3523602;Itirapina;2016;25;1,51;25;1,51;0;0
3523602;Itirapina;2017;25;1,5;25;1,5;0;0
3523602;Itirapina;2018;25;1,48;25;1,48;0;0
3523602;Itirapina;2019;25;1,47;25;1,47;0;0
3523701;Itirapuã;2010;0;0;0;0;0;0
3523701;Itirapuã;2011;0;0;0;0;0;0
3523701;Itirapuã;2012;0;0;0;0;0;0
3523701;Itirapuã;2013;0;0;0;0;0;0
3523701;Itirapuã;2014;0;0;0;0;0;0
3523701;Itirapuã;2015;0;0;0;0;0;0
3523701;Itirapuã;2016;0;0;0;0;0;0
3523701;Itirapuã;2017;0;0;0;0;0;0
3523701;Itirapuã;2018;0;0;0;0;0;0
3523701;Itirapuã;2019;0;0;0;0;0;0
3523800;Itobi;2010;0;0;0;0;0;0
3523800;Itobi;2011;0;0;0;0;0;0
3523800;Itobi;2012;0;0;0;0;0;0
3523800;Itobi;2013;0;0;0;0;0;0
3523800;Itobi;2014;0;0;0;0;0;0
3523800;Itobi;2015;0;0;0;0;0;0
3523800;Itobi;2016;0;0;0;0;0;0
3523800;Itobi;2017;0;0;0;0;0;0
3523800;Itobi;2018;0;0;0;0;0;0
3523800;Itobi;2019;0;0;0;0;0;0
3523909;Itu;2010;503;3,27;391;2,54;112;0,73
3523909;Itu;2011;426;2,74;391;2,51;35;0,22
3523909;Itu;2012;426;2,71;391;2,49;35;0,22
3523909;Itu;2013;426;2,68;391;2,46;35;0,22
3523909;Itu;2014;426;2,65;391;2,43;35;0,22
3523909;Itu;2015;426;2,62;391;2,41;35;0,22
3523909;Itu;2016;385;2,35;345;2,11;40;0,24
3523909;Itu;2017;463;2,8;423;2,56;40;0,24
3523909;Itu;2018;458;2,75;426;2,55;32;0,19
3523909;Itu;2019;389;2,31;357;2,12;32;0,19
3524006;Itupeva;2010;86;1,93;48;1,07;38;0,85
3524006;Itupeva;2011;86;1,87;48;1,04;38;0,82
3524006;Itupeva;2012;86;1,81;48;1,01;38;0,8
3524006;Itupeva;2013;86;1,75;48;0,98;38;0,77
3524006;Itupeva;2014;86;1,7;48;0,95;38;0,75
3524006;Itupeva;2015;86;1,65;48;0,92;38;0,73
3524006;Itupeva;2016;86;1,61;48;0,9;38;0,71
3524006;Itupeva;2017;86;1,57;48;0,87;38;0,69
3524006;Itupeva;2018;86;1,53;48;0,85;38;0,68
3524006;Itupeva;2019;86;1,49;48;0,83;38;0,66
3524105;Ituverava;2010;124;3,21;62;1,6;62;1,6
3524105;Ituverava;2011;120;3,09;58;1,49;62;1,6
3524105;Ituverava;2012;120;3,08;58;1,49;62;1,59
3524105;Ituverava;2013;120;3,06;58;1,48;62;1,58
3524105;Ituverava;2014;120;3,05;58;1,47;62;1,57
3524105;Ituverava;2015;121;3,06;55;1,39;66;1,67
3524105;Ituverava;2016;121;3,05;55;1,39;66;1,66
3524105;Ituverava;2017;121;3,04;55;1,38;66;1,66
3524105;Ituverava;2018;121;3,03;55;1,38;66;1,65
3524105;Ituverava;2019;120;2,99;53;1,32;67;1,67
3524204;Jaborandi;2010;23;3,49;23;3,49;0;0
3524204;Jaborandi;2011;23;3,48;23;3,48;0;0
3524204;Jaborandi;2012;17;2,57;17;2,57;0;0
3524204;Jaborandi;2013;17;2,57;17;2,57;0;0
3524204;Jaborandi;2014;17;2,56;17;2,56;0;0
3524204;Jaborandi;2015;17;2,56;17;2,56;0;0
3524204;Jaborandi;2016;17;2,56;17;2,56;0;0
3524204;Jaborandi;2017;17;2,55;17;2,55;0;0
3524204;Jaborandi;2018;17;2,55;17;2,55;0;0
3524204;Jaborandi;2019;17;2,55;17;2,55;0;0
3524303;Jaboticabal;2010;141;1,97;59;0,82;82;1,14
3524303;Jaboticabal;2011;122;1,7;51;0,71;71;0,99
3524303;Jaboticabal;2012;136;1,88;66;0,91;70;0,97
3524303;Jaboticabal;2013;136;1,88;71;0,98;65;0,9
3524303;Jaboticabal;2014;143;1,96;56;0,77;87;1,2
3524303;Jaboticabal;2015;172;2,35;56;0,77;116;1,59
3524303;Jaboticabal;2016;172;2,35;56;0,76;116;1,58
3524303;Jaboticabal;2017;212;2,88;56;0,76;156;2,12
3524303;Jaboticabal;2018;212;2,87;56;0,76;156;2,11
3524303;Jaboticabal;2019;212;2,87;56;0,76;156;2,11
3524402;Jacareí;2010;418;1,98;199;0,94;219;1,04
3524402;Jacareí;2011;383;1,8;179;0,84;204;0,96
3524402;Jacareí;2012;383;1,78;205;0,96;178;0,83
3524402;Jacareí;2013;421;1,95;211;0,97;210;0,97
3524402;Jacareí;2014;421;1,93;211;0,97;210;0,96
3524402;Jacareí;2015;440;2;211;0,96;229;1,04
3524402;Jacareí;2016;440;1,99;211;0,95;229;1,03
3524402;Jacareí;2017;389;1,74;161;0,72;228;1,02
3524402;Jacareí;2018;395;1,76;167;0,74;228;1,01
3524402;Jacareí;2019;404;1,78;167;0,74;237;1,05
3524501;Jaci;2010;177;31,37;135;23,93;42;7,44
3524501;Jaci;2011;177;30,64;135;23,37;42;7,27
3524501;Jaci;2012;177;29,93;135;22,83;42;7,1
3524501;Jaci;2013;177;29,24;135;22,3;42;6,94
3524501;Jaci;2014;179;28,88;151;24,37;28;4,52
3524501;Jaci;2015;191;30,11;150;23,64;41;6,46
3524501;Jaci;2016;191;29,55;150;23,21;41;6,34
3524501;Jaci;2017;216;32,79;150;22,77;66;10,02
3524501;Jaci;2018;216;32,18;150;22,35;66;9,83
3524501;Jaci;2019;216;31,58;149;21,79;67;9,8
3524600;Jacupiranga;2010;0;0;0;0;0;0
3524600;Jacupiranga;2011;0;0;0;0;0;0
3524600;Jacupiranga;2012;0;0;0;0;0;0
3524600;Jacupiranga;2013;0;0;0;0;0;0
3524600;Jacupiranga;2014;0;0;0;0;0;0
3524600;Jacupiranga;2015;0;0;0;0;0;0
3524600;Jacupiranga;2016;0;0;0;0;0;0
3524600;Jacupiranga;2017;0;0;0;0;0;0
3524600;Jacupiranga;2018;0;0;0;0;0;0
3524600;Jacupiranga;2019;0;0;0;0;0;0
3524709;Jaguariúna;2010;75;1,7;75;1,7;0;0
3524709;Jaguariúna;2011;75;1,65;75;1,65;0;0
3524709;Jaguariúna;2012;75;1,61;75;1,61;0;0
3524709;Jaguariúna;2013;80;1,67;78;1,63;2;0,04
3524709;Jaguariúna;2014;80;1,63;78;1,59;2;0,04
3524709;Jaguariúna;2015;80;1,59;78;1,55;2;0,04
3524709;Jaguariúna;2016;80;1,56;78;1,52;2;0,04
3524709;Jaguariúna;2017;80;1,53;78;1,5;2;0,04
3524709;Jaguariúna;2018;80;1,51;78;1,47;2;0,04
3524709;Jaguariúna;2019;80;1,48;78;1,45;2;0,04
3524808;Jales;2010;119;2,53;70;1,49;49;1,04
3524808;Jales;2011;129;2,74;70;1,49;59;1,25
3524808;Jales;2012;144;3,06;70;1,49;74;1,57
3524808;Jales;2013;165;3,5;70;1,49;95;2,02
3524808;Jales;2014;165;3,5;112;2,38;53;1,12
3524808;Jales;2015;165;3,5;112;2,37;53;1,12
3524808;Jales;2016;165;3,5;112;2,37;53;1,12
3524808;Jales;2017;163;3,45;112;2,37;51;1,08
3524808;Jales;2018;154;3,26;103;2,18;51;1,08
3524808;Jales;2019;151;3,2;103;2,18;48;1,02
3524907;Jambeiro;2010;0;0;0;0;0;0
3524907;Jambeiro;2011;0;0;0;0;0;0
3524907;Jambeiro;2012;0;0;0;0;0;0
3524907;Jambeiro;2013;0;0;0;0;0;0
3524907;Jambeiro;2014;0;0;0;0;0;0
3524907;Jambeiro;2015;0;0;0;0;0;0
3524907;Jambeiro;2016;0;0;0;0;0;0
3524907;Jambeiro;2017;0;0;0;0;0;0
3524907;Jambeiro;2018;0;0;0;0;0;0
3524907;Jambeiro;2019;0;0;0;0;0;0
3525003;Jandira;2010;166;1,53;70;0,65;96;0,89
3525003;Jandira;2011;35;0,32;31;0,28;4;0,04
3525003;Jandira;2012;58;0,52;44;0,4;14;0,13
3525003;Jandira;2013;58;0,51;44;0,39;14;0,12
3525003;Jandira;2014;40;0,35;26;0,23;14;0,12
3525003;Jandira;2015;40;0,34;26;0,22;14;0,12
3525003;Jandira;2016;14;0,12;0;0;14;0,12
3525003;Jandira;2017;14;0,12;0;0;14;0,12
3525003;Jandira;2018;14;0,12;0;0;14;0,12
3525003;Jandira;2019;15;0,12;0;0;15;0,12
3525102;Jardinópolis;2010;0;0;0;0;0;0
3525102;Jardinópolis;2011;0;0;0;0;0;0
3525102;Jardinópolis;2012;0;0;0;0;0;0
3525102;Jardinópolis;2013;0;0;0;0;0;0
3525102;Jardinópolis;2014;0;0;0;0;0;0
3525102;Jardinópolis;2015;0;0;0;0;0;0
3525102;Jardinópolis;2016;0;0;0;0;0;0
3525102;Jardinópolis;2017;0;0;0;0;0;0
3525102;Jardinópolis;2018;0;0;0;0;0;0
3525102;Jardinópolis;2019;0;0;0;0;0;0
3525201;Jarinu;2010;11;0,46;11;0,46;0;0
3525201;Jarinu;2011;12;0,49;12;0,49;0;0
3525201;Jarinu;2012;33;1,32;12;0,48;21;0,84
3525201;Jarinu;2013;33;1,29;12;0,47;21;0,82
3525201;Jarinu;2014;33;1,26;12;0,46;21;0,8
3525201;Jarinu;2015;33;1,22;12;0,45;21;0,78
3525201;Jarinu;2016;37;1,34;17;0,62;20;0,73
3525201;Jarinu;2017;37;1,32;17;0,61;20;0,71
3525201;Jarinu;2018;49;1,71;17;0,59;32;1,12
3525201;Jarinu;2019;29;0,99;17;0,58;12;0,41
3525300;Jaú;2010;923;7,05;728;5,56;195;1,49
3525300;Jaú;2011;922;6,95;735;5,54;187;1,41
3525300;Jaú;2012;919;6,84;733;5,45;186;1,38
3525300;Jaú;2013;860;6,32;705;5,18;155;1,14
3525300;Jaú;2014;860;6,23;705;5,11;155;1,12
3525300;Jaú;2015;860;6,15;705;5,04;155;1,11
3525300;Jaú;2016;860;6,08;705;4,99;155;1,1
3525300;Jaú;2017;905;6,33;715;5;190;1,33
3525300;Jaú;2018;905;6,27;715;4,95;190;1,32
3525300;Jaú;2019;895;6,13;711;4,87;184;1,26
3525409;Jeriquara;2010;0;0;0;0;0;0
3525409;Jeriquara;2011;0;0;0;0;0;0
3525409;Jeriquara;2012;0;0;0;0;0;0
3525409;Jeriquara;2013;0;0;0;0;0;0
3525409;Jeriquara;2014;0;0;0;0;0;0
3525409;Jeriquara;2015;0;0;0;0;0;0
3525409;Jeriquara;2016;0;0;0;0;0;0
3525409;Jeriquara;2017;0;0;0;0;0;0
3525409;Jeriquara;2018;0;0;0;0;0;0
3525409;Jeriquara;2019;0;0;0;0;0;0
3525508;Joanópolis;2010;19;1,62;19;1,62;0;0
3525508;Joanópolis;2011;24;2,02;17;1,43;7;0,59
3525508;Joanópolis;2012;24;2,01;17;1,42;7;0,59
3525508;Joanópolis;2013;24;1,99;17;1,41;7;0,58
3525508;Joanópolis;2014;24;1,97;17;1,4;7;0,58
3525508;Joanópolis;2015;24;1,96;17;1,39;7;0,57
3525508;Joanópolis;2016;24;1,95;17;1,38;7;0,57
3525508;Joanópolis;2017;11;0,89;11;0,89;0;0
3525508;Joanópolis;2018;11;0,88;11;0,88;0;0
3525508;Joanópolis;2019;11;0,87;11;0,87;0;0
3525607;João Ramalho;2010;0;0;0;0;0;0
3525607;João Ramalho;2011;0;0;0;0;0;0
3525607;João Ramalho;2012;0;0;0;0;0;0
3525607;João Ramalho;2013;0;0;0;0;0;0
3525607;João Ramalho;2014;0;0;0;0;0;0
3525607;João Ramalho;2015;0;0;0;0;0;0
3525607;João Ramalho;2016;0;0;0;0;0;0
3525607;João Ramalho;2017;0;0;0;0;0;0
3525607;João Ramalho;2018;0;0;0;0;0;0
3525607;João Ramalho;2019;0;0;0;0;0;0
3525706;José Bonifácio;2010;61;1,86;40;1,22;21;0,64
3525706;José Bonifácio;2011;61;1,85;40;1,21;21;0,64
3525706;José Bonifácio;2012;61;1,83;34;1,02;27;0,81
3525706;José Bonifácio;2013;61;1,81;34;1,01;27;0,8
3525706;José Bonifácio;2014;61;1,79;40;1,17;21;0,62
3525706;José Bonifácio;2015;61;1,77;29;0,84;32;0,93
3525706;José Bonifácio;2016;61;1,76;28;0,81;33;0,95
3525706;José Bonifácio;2017;61;1,74;28;0,8;33;0,94
3525706;José Bonifácio;2018;53;1,5;22;0,62;31;0,88
3525706;José Bonifácio;2019;53;1,49;22;0,62;31;0,87
3525805;Júlio Mesquita;2010;0;0;0;0;0;0
3525805;Júlio Mesquita;2011;0;0;0;0;0;0
3525805;Júlio Mesquita;2012;0;0;0;0;0;0
3525805;Júlio Mesquita;2013;0;0;0;0;0;0
3525805;Júlio Mesquita;2014;0;0;0;0;0;0
3525805;Júlio Mesquita;2015;0;0;0;0;0;0
3525805;Júlio Mesquita;2016;0;0;0;0;0;0
3525805;Júlio Mesquita;2017;0;0;0;0;0;0
3525805;Júlio Mesquita;2018;0;0;0;0;0;0
3525805;Júlio Mesquita;2019;0;0;0;0;0;0
3525854;Jumirim;2010;0;0;0;0;0;0
3525854;Jumirim;2011;0;0;0;0;0;0
3525854;Jumirim;2012;0;0;0;0;0;0
3525854;Jumirim;2013;0;0;0;0;0;0
3525854;Jumirim;2014;0;0;0;0;0;0
3525854;Jumirim;2015;0;0;0;0;0;0
3525854;Jumirim;2016;0;0;0;0;0;0
3525854;Jumirim;2017;0;0;0;0;0;0
3525854;Jumirim;2018;0;0;0;0;0;0
3525854;Jumirim;2019;0;0;0;0;0;0
3525904;Jundiaí;2010;652;1,76;280;0,76;372;1,01
3525904;Jundiaí;2011;640;1,71;281;0,75;359;0,96
3525904;Jundiaí;2012;641;1,7;282;0,75;359;0,95
3525904;Jundiaí;2013;664;1,74;308;0,81;356;0,93
3525904;Jundiaí;2014;695;1,8;321;0,83;374;0,97
3525904;Jundiaí;2015;800;2,05;376;0,96;424;1,08
3525904;Jundiaí;2016;796;2,02;386;0,98;410;1,04
3525904;Jundiaí;2017;812;2,04;440;1,11;372;0,94
3525904;Jundiaí;2018;824;2,06;439;1,1;385;0,96
3525904;Jundiaí;2019;824;2,04;439;1,09;385;0,95
3526001;Junqueirópolis;2010;52;2,78;26;1,39;26;1,39
3526001;Junqueirópolis;2011;52;2,76;26;1,38;26;1,38
3526001;Junqueirópolis;2012;52;2,74;26;1,37;26;1,37
3526001;Junqueirópolis;2013;52;2,72;26;1,36;26;1,36
3526001;Junqueirópolis;2014;52;2,7;26;1,35;26;1,35
3526001;Junqueirópolis;2015;52;2,68;26;1,34;26;1,34
3526001;Junqueirópolis;2016;52;2,66;26;1,33;26;1,33
3526001;Junqueirópolis;2017;51;2,59;25;1,27;26;1,32
3526001;Junqueirópolis;2018;52;2,63;25;1,26;27;1,36
3526001;Junqueirópolis;2019;52;2,61;25;1,25;27;1,35
3526100;Juquiá;2010;13;0,68;13;0,68;0;0
3526100;Juquiá;2011;17;0,89;17;0,89;0;0
3526100;Juquiá;2012;15;0,78;15;0,78;0;0
3526100;Juquiá;2013;15;0,79;15;0,79;0;0
3526100;Juquiá;2014;15;0,79;15;0,79;0;0
3526100;Juquiá;2015;15;0,79;15;0,79;0;0
3526100;Juquiá;2016;15;0,79;15;0,79;0;0
3526100;Juquiá;2017;15;0,79;15;0,79;0;0
3526100;Juquiá;2018;0;0;0;0;0;0
3526100;Juquiá;2019;0;0;0;0;0;0
3526209;Juquitiba;2010;24;0,84;24;0,84;0;0
3526209;Juquitiba;2011;24;0,83;24;0,83;0;0
3526209;Juquitiba;2012;24;0,83;24;0,83;0;0
3526209;Juquitiba;2013;9;0,31;0;0;9;0,31
3526209;Juquitiba;2014;9;0,31;0;0;9;0,31
3526209;Juquitiba;2015;9;0,31;0;0;9;0,31
3526209;Juquitiba;2016;9;0,3;0;0;9;0,3
3526209;Juquitiba;2017;9;0,3;0;0;9;0,3
3526209;Juquitiba;2018;59;1,96;0;0;59;1,96
3526209;Juquitiba;2019;59;1,95;0;0;59;1,95
3526308;Lagoinha;2010;0;0;0;0;0;0
3526308;Lagoinha;2011;0;0;0;0;0;0
3526308;Lagoinha;2012;0;0;0;0;0;0
3526308;Lagoinha;2013;0;0;0;0;0;0
3526308;Lagoinha;2014;0;0;0;0;0;0
3526308;Lagoinha;2015;0;0;0;0;0;0
3526308;Lagoinha;2016;0;0;0;0;0;0
3526308;Lagoinha;2017;0;0;0;0;0;0
3526308;Lagoinha;2018;0;0;0;0;0;0
3526308;Lagoinha;2019;0;0;0;0;0;0
3526407;Laranjal Paulista;2010;47;1,86;33;1,31;14;0,56
3526407;Laranjal Paulista;2011;47;1,84;33;1,29;14;0,55
3526407;Laranjal Paulista;2012;47;1,82;33;1,28;14;0,54
3526407;Laranjal Paulista;2013;75;2,88;58;2,23;17;0,65
3526407;Laranjal Paulista;2014;47;1,79;32;1,22;15;0,57
3526407;Laranjal Paulista;2015;47;1,77;32;1,2;15;0,56
3526407;Laranjal Paulista;2016;47;1,75;32;1,19;15;0,56
3526407;Laranjal Paulista;2017;46;1,7;28;1,03;18;0,66
3526407;Laranjal Paulista;2018;46;1,68;28;1,02;18;0,66
3526407;Laranjal Paulista;2019;46;1,67;28;1,02;18;0,65
3526506;Lavínia;2010;0;0;0;0;0;0
3526506;Lavínia;2011;0;0;0;0;0;0
3526506;Lavínia;2012;0;0;0;0;0;0
3526506;Lavínia;2013;0;0;0;0;0;0
3526506;Lavínia;2014;0;0;0;0;0;0
3526506;Lavínia;2015;0;0;0;0;0;0
3526506;Lavínia;2016;0;0;0;0;0;0
3526506;Lavínia;2017;0;0;0;0;0;0
3526506;Lavínia;2018;0;0;0;0;0;0
3526506;Lavínia;2019;0;0;0;0;0;0
3526605;Lavrinhas;2010;0;0;0;0;0;0
3526605;Lavrinhas;2011;0;0;0;0;0;0
3526605;Lavrinhas;2012;0;0;0;0;0;0
3526605;Lavrinhas;2013;0;0;0;0;0;0
3526605;Lavrinhas;2014;0;0;0;0;0;0
3526605;Lavrinhas;2015;0;0;0;0;0;0
3526605;Lavrinhas;2016;0;0;0;0;0;0
3526605;Lavrinhas;2017;0;0;0;0;0;0
3526605;Lavrinhas;2018;0;0;0;0;0;0
3526605;Lavrinhas;2019;0;0;0;0;0;0
3526704;Leme;2010;127;1,39;76;0,83;51;0,56
3526704;Leme;2011;127;1,37;76;0,82;51;0,55
3526704;Leme;2012;127;1,36;76;0,81;51;0,55
3526704;Leme;2013;127;1,34;76;0,8;51;0,54
3526704;Leme;2014;127;1,33;76;0,8;51;0,53
3526704;Leme;2015;124;1,28;76;0,79;48;0,5
3526704;Leme;2016;130;1,33;83;0,85;47;0,48
3526704;Leme;2017;144;1,47;105;1,07;39;0,4
3526704;Leme;2018;141;1,42;77;0,78;64;0,65
3526704;Leme;2019;122;1,22;77;0,77;45;0,45
3526803;Lençóis Paulista;2010;80;1,3;55;0,9;25;0,41
3526803;Lençóis Paulista;2011;80;1,29;57;0,92;23;0,37
3526803;Lençóis Paulista;2012;80;1,28;57;0,91;23;0,37
3526803;Lençóis Paulista;2013;80;1,27;57;0,91;23;0,37
3526803;Lençóis Paulista;2014;80;1,26;57;0,9;23;0,36
3526803;Lençóis Paulista;2015;81;1,27;54;0,84;27;0,42
3526803;Lençóis Paulista;2016;81;1,26;54;0,84;27;0,42
3526803;Lençóis Paulista;2017;87;1,34;60;0,92;27;0,42
3526803;Lençóis Paulista;2018;87;1,33;60;0,92;27;0,41
3526803;Lençóis Paulista;2019;88;1,34;45;0,68;43;0,65
3526902;Limeira;2010;411;1,49;209;0,76;202;0,73
3526902;Limeira;2011;400;1,44;203;0,73;197;0,71
3526902;Limeira;2012;431;1,54;237;0,85;194;0,69
3526902;Limeira;2013;431;1,53;234;0,83;197;0,7
3526902;Limeira;2014;407;1,43;216;0,76;191;0,67
3526902;Limeira;2015;404;1,41;200;0,7;204;0,71
3526902;Limeira;2016;398;1,38;199;0,69;199;0,69
3526902;Limeira;2017;405;1,39;200;0,69;205;0,71
3526902;Limeira;2018;375;1,28;180;0,62;195;0,67
3526902;Limeira;2019;377;1,28;174;0,59;203;0,69
3527009;Lindóia;2010;0;0;0;0;0;0
3527009;Lindóia;2011;0;0;0;0;0;0
3527009;Lindóia;2012;0;0;0;0;0;0
3527009;Lindóia;2013;0;0;0;0;0;0
3527009;Lindóia;2014;0;0;0;0;0;0
3527009;Lindóia;2015;0;0;0;0;0;0
3527009;Lindóia;2016;0;0;0;0;0;0
3527009;Lindóia;2017;0;0;0;0;0;0
3527009;Lindóia;2018;0;0;0;0;0;0
3527009;Lindóia;2019;0;0;0;0;0;0
3527108;Lins;2010;524;7,34;419;5,87;105;1,47
3527108;Lins;2011;484;6,74;379;5,28;105;1,46
3527108;Lins;2012;484;6,7;379;5,25;105;1,45
3527108;Lins;2013;446;6,14;349;4,8;97;1,34
3527108;Lins;2014;446;6,1;349;4,78;97;1,33
3527108;Lins;2015;444;6,04;349;4,75;95;1,29
3527108;Lins;2016;451;6,11;349;4,73;102;1,38
3527108;Lins;2017;453;6,11;349;4,71;104;1,4
3527108;Lins;2018;448;6,02;344;4,62;104;1,4
3527108;Lins;2019;428;5,72;324;4,33;104;1,39
3527207;Lorena;2010;160;1,94;90;1,09;70;0,85
3527207;Lorena;2011;160;1,93;90;1,09;70;0,84
3527207;Lorena;2012;173;2,08;105;1,26;68;0,82
3527207;Lorena;2013;173;2,06;105;1,25;68;0,81
3527207;Lorena;2014;165;1,96;84;1;81;0,96
3527207;Lorena;2015;170;2,01;82;0,97;88;1,04
3527207;Lorena;2016;172;2,02;81;0,95;91;1,07
3527207;Lorena;2017;164;1,92;85;0,99;79;0,92
3527207;Lorena;2018;164;1,91;85;0,99;79;0,92
3527207;Lorena;2019;164;1,9;85;0,99;79;0,92
3527256;Lourdes;2010;0;0;0;0;0;0
3527256;Lourdes;2011;0;0;0;0;0;0
3527256;Lourdes;2012;0;0;0;0;0;0
3527256;Lourdes;2013;0;0;0;0;0;0
3527256;Lourdes;2014;0;0;0;0;0;0
3527256;Lourdes;2015;0;0;0;0;0;0
3527256;Lourdes;2016;0;0;0;0;0;0
3527256;Lourdes;2017;0;0;0;0;0;0
3527256;Lourdes;2018;0;0;0;0;0;0
3527256;Lourdes;2019;0;0;0;0;0;0
3527306;Louveira;2010;27;0,73;24;0,65;3;0,08
3527306;Louveira;2011;27;0,71;24;0,63;3;0,08
3527306;Louveira;2012;41;1,04;34;0,86;7;0,18
3527306;Louveira;2013;41;1,01;34;0,84;7;0,17
3527306;Louveira;2014;41;0,98;34;0,81;7;0,17
3527306;Louveira;2015;41;0,95;34;0,78;7;0,16
3527306;Louveira;2016;36;0,81;29;0,66;7;0,16
3527306;Louveira;2017;34;0,75;27;0,6;7;0,15
3527306;Louveira;2018;34;0,74;27;0,58;7;0,15
3527306;Louveira;2019;36;0,76;31;0,66;5;0,11
3527405;Lucélia;2010;67;3,37;48;2,42;19;0,96
3527405;Lucélia;2011;67;3,35;48;2,4;19;0,95
3527405;Lucélia;2012;67;3,33;48;2,39;19;0,94
3527405;Lucélia;2013;67;3,31;48;2,37;19;0,94
3527405;Lucélia;2014;58;2,85;38;1,87;20;0,98
3527405;Lucélia;2015;25;1,22;15;0,73;10;0,49
3527405;Lucélia;2016;25;1,21;15;0,73;10;0,49
3527405;Lucélia;2017;15;0,72;10;0,48;5;0,24
3527405;Lucélia;2018;15;0,72;10;0,48;5;0,24
3527405;Lucélia;2019;15;0,72;10;0,48;5;0,24
3527504;Lucianópolis;2010;0;0;0;0;0;0
3527504;Lucianópolis;2011;0;0;0;0;0;0
3527504;Lucianópolis;2012;0;0;0;0;0;0
3527504;Lucianópolis;2013;0;0;0;0;0;0
3527504;Lucianópolis;2014;0;0;0;0;0;0
3527504;Lucianópolis;2015;0;0;0;0;0;0
3527504;Lucianópolis;2016;0;0;0;0;0;0
3527504;Lucianópolis;2017;0;0;0;0;0;0
3527504;Lucianópolis;2018;0;0;0;0;0;0
3527504;Lucianópolis;2019;0;0;0;0;0;0
3527603;Luís Antônio;2010;0;0;0;0;0;0
3527603;Luís Antônio;2011;0;0;0;0;0;0
3527603;Luís Antônio;2012;0;0;0;0;0;0
3527603;Luís Antônio;2013;0;0;0;0;0;0
3527603;Luís Antônio;2014;0;0;0;0;0;0
3527603;Luís Antônio;2015;0;0;0;0;0;0
3527603;Luís Antônio;2016;0;0;0;0;0;0
3527603;Luís Antônio;2017;0;0;0;0;0;0
3527603;Luís Antônio;2018;0;0;0;0;0;0
3527603;Luís Antônio;2019;0;0;0;0;0;0
3527702;Luiziânia;2010;32;6,37;15;2,99;17;3,38
3527702;Luiziânia;2011;32;6,28;15;2,94;17;3,34
3527702;Luiziânia;2012;32;6,19;15;2,9;17;3,29
3527702;Luiziânia;2013;32;6,1;15;2,86;17;3,24
3527702;Luiziânia;2014;32;6,02;15;2,82;17;3,2
3527702;Luiziânia;2015;32;5,93;15;2,78;17;3,15
3527702;Luiziânia;2016;32;5,86;15;2,74;17;3,11
3527702;Luiziânia;2017;0;0;0;0;0;0
3527702;Luiziânia;2018;3;0,54;3;0,54;0;0
3527702;Luiziânia;2019;3;0,53;3;0,53;0;0
3527801;Lupércio;2010;0;0;0;0;0;0
3527801;Lupércio;2011;0;0;0;0;0;0
3527801;Lupércio;2012;0;0;0;0;0;0
3527801;Lupércio;2013;0;0;0;0;0;0
3527801;Lupércio;2014;0;0;0;0;0;0
3527801;Lupércio;2015;0;0;0;0;0;0
3527801;Lupércio;2016;0;0;0;0;0;0
3527801;Lupércio;2017;0;0;0;0;0;0
3527801;Lupércio;2018;0;0;0;0;0;0
3527801;Lupércio;2019;0;0;0;0;0;0
3527900;Lutécia;2010;0;0;0;0;0;0
3527900;Lutécia;2011;0;0;0;0;0;0
3527900;Lutécia;2012;0;0;0;0;0;0
3527900;Lutécia;2013;0;0;0;0;0;0
3527900;Lutécia;2014;0;0;0;0;0;0
3527900;Lutécia;2015;0;0;0;0;0;0
3527900;Lutécia;2016;0;0;0;0;0;0
3527900;Lutécia;2017;0;0;0;0;0;0
3527900;Lutécia;2018;0;0;0;0;0;0
3527900;Lutécia;2019;0;0;0;0;0;0
3528007;Macatuba;2010;31;1,91;18;1,11;13;0,8
3528007;Macatuba;2011;31;1,9;18;1,1;13;0,8
3528007;Macatuba;2012;31;1,89;18;1,1;13;0,79
3528007;Macatuba;2013;31;1,88;18;1,09;13;0,79
3528007;Macatuba;2014;31;1,87;18;1,09;13;0,79
3528007;Macatuba;2015;31;1,87;18;1,08;13;0,78
3528007;Macatuba;2016;31;1,86;18;1,08;13;0,78
3528007;Macatuba;2017;31;1,85;18;1,08;13;0,78
3528007;Macatuba;2018;31;1,85;18;1,07;13;0,77
3528007;Macatuba;2019;31;1,84;18;1,07;13;0,77
3528106;Macaubal;2010;24;3,13;5;0,65;19;2,48
3528106;Macaubal;2011;24;3,13;5;0,65;19;2,48
3528106;Macaubal;2012;24;3,12;5;0,65;19;2,47
3528106;Macaubal;2013;24;3,12;5;0,65;19;2,47
3528106;Macaubal;2014;24;3,11;13;1,68;11;1,43
3528106;Macaubal;2015;24;3,1;13;1,68;11;1,42
3528106;Macaubal;2016;18;2,33;15;1,94;3;0,39
3528106;Macaubal;2017;18;2,33;15;1,94;3;0,39
3528106;Macaubal;2018;18;2,32;15;1,94;3;0,39
3528106;Macaubal;2019;18;2,32;15;1,94;3;0,39
3528205;Macedônia;2010;0;0;0;0;0;0
3528205;Macedônia;2011;0;0;0;0;0;0
3528205;Macedônia;2012;0;0;0;0;0;0
3528205;Macedônia;2013;0;0;0;0;0;0
3528205;Macedônia;2014;0;0;0;0;0;0
3528205;Macedônia;2015;0;0;0;0;0;0
3528205;Macedônia;2016;0;0;0;0;0;0
3528205;Macedônia;2017;0;0;0;0;0;0
3528205;Macedônia;2018;0;0;0;0;0;0
3528205;Macedônia;2019;0;0;0;0;0;0
3528304;Magda;2010;0;0;0;0;0;0
3528304;Magda;2011;0;0;0;0;0;0
3528304;Magda;2012;0;0;0;0;0;0
3528304;Magda;2013;0;0;0;0;0;0
3528304;Magda;2014;0;0;0;0;0;0
3528304;Magda;2015;0;0;0;0;0;0
3528304;Magda;2016;0;0;0;0;0;0
3528304;Magda;2017;0;0;0;0;0;0
3528304;Magda;2018;0;0;0;0;0;0
3528304;Magda;2019;0;0;0;0;0;0
3528403;Mairinque;2010;0;0;0;0;0;0
3528403;Mairinque;2011;0;0;0;0;0;0
3528403;Mairinque;2012;0;0;0;0;0;0
3528403;Mairinque;2013;0;0;0;0;0;0
3528403;Mairinque;2014;0;0;0;0;0;0
3528403;Mairinque;2015;0;0;0;0;0;0
3528403;Mairinque;2016;0;0;0;0;0;0
3528403;Mairinque;2017;0;0;0;0;0;0
3528403;Mairinque;2018;0;0;0;0;0;0
3528403;Mairinque;2019;0;0;0;0;0;0
3528502;Mairiporã;2010;47;0,58;47;0,58;0;0
3528502;Mairiporã;2011;47;0,57;47;0,57;0;0
3528502;Mairiporã;2012;47;0,56;47;0,56;0;0
3528502;Mairiporã;2013;47;0,54;47;0,54;0;0
3528502;Mairiporã;2014;47;0,53;47;0,53;0;0
3528502;Mairiporã;2015;47;0,52;47;0,52;0;0
3528502;Mairiporã;2016;72;0,78;47;0,51;25;0,27
3528502;Mairiporã;2017;72;0,77;41;0,44;31;0,33
3528502;Mairiporã;2018;47;0,49;41;0,43;6;0,06
3528502;Mairiporã;2019;47;0,49;41;0,42;6;0,06
3528601;Manduri;2010;0;0;0;0;0;0
3528601;Manduri;2011;0;0;0;0;0;0
3528601;Manduri;2012;0;0;0;0;0;0
3528601;Manduri;2013;0;0;0;0;0;0
3528601;Manduri;2014;0;0;0;0;0;0
3528601;Manduri;2015;0;0;0;0;0;0
3528601;Manduri;2016;0;0;0;0;0;0
3528601;Manduri;2017;0;0;0;0;0;0
3528601;Manduri;2018;0;0;0;0;0;0
3528601;Manduri;2019;0;0;0;0;0;0
3528700;Marabá Paulista;2010;0;0;0;0;0;0
3528700;Marabá Paulista;2011;0;0;0;0;0;0
3528700;Marabá Paulista;2012;0;0;0;0;0;0
3528700;Marabá Paulista;2013;0;0;0;0;0;0
3528700;Marabá Paulista;2014;0;0;0;0;0;0
3528700;Marabá Paulista;2015;0;0;0;0;0;0
3528700;Marabá Paulista;2016;0;0;0;0;0;0
3528700;Marabá Paulista;2017;0;0;0;0;0;0
3528700;Marabá Paulista;2018;0;0;0;0;0;0
3528700;Marabá Paulista;2019;0;0;0;0;0;0
3528809;Maracaí;2010;27;2,03;22;1,65;5;0,38
3528809;Maracaí;2011;27;2,02;22;1,65;5;0,37
3528809;Maracaí;2012;26;1,94;22;1,65;4;0,3
3528809;Maracaí;2013;26;1,94;26;1,94;0;0
3528809;Maracaí;2014;26;1,94;26;1,94;0;0
3528809;Maracaí;2015;26;1,93;26;1,93;0;0
3528809;Maracaí;2016;26;1,93;22;1,63;4;0,3
3528809;Maracaí;2017;26;1,93;22;1,63;4;0,3
3528809;Maracaí;2018;26;1,93;22;1,63;4;0,3
3528809;Maracaí;2019;26;1,93;22;1,63;4;0,3
3528858;Marapoama;2010;0;0;0;0;0;0
3528858;Marapoama;2011;0;0;0;0;0;0
3528858;Marapoama;2012;0;0;0;0;0;0
3528858;Marapoama;2013;0;0;0;0;0;0
3528858;Marapoama;2014;0;0;0;0;0;0
3528858;Marapoama;2015;0;0;0;0;0;0
3528858;Marapoama;2016;0;0;0;0;0;0
3528858;Marapoama;2017;0;0;0;0;0;0
3528858;Marapoama;2018;0;0;0;0;0;0
3528858;Marapoama;2019;0;0;0;0;0;0
3528908;Mariápolis;2010;0;0;0;0;0;0
3528908;Mariápolis;2011;0;0;0;0;0;0
3528908;Mariápolis;2012;0;0;0;0;0;0
3528908;Mariápolis;2013;0;0;0;0;0;0
3528908;Mariápolis;2014;0;0;0;0;0;0
3528908;Mariápolis;2015;0;0;0;0;0;0
3528908;Mariápolis;2016;0;0;0;0;0;0
3528908;Mariápolis;2017;0;0;0;0;0;0
3528908;Mariápolis;2018;0;0;0;0;0;0
3528908;Mariápolis;2019;0;0;0;0;0;0
3529005;Marília;2010;993;4,58;755;3,49;238;1,1
3529005;Marília;2011;887;4,07;728;3,34;159;0,73
3529005;Marília;2012;887;4,04;728;3,31;159;0,72
3529005;Marília;2013;895;4,04;750;3,39;145;0,65
3529005;Marília;2014;860;3,86;729;3,27;131;0,59
3529005;Marília;2015;854;3,8;709;3,16;145;0,65
3529005;Marília;2016;890;3,94;709;3,14;181;0,8
3529005;Marília;2017;742;3,26;564;2,48;178;0,78
3529005;Marília;2018;875;3,82;663;2,9;212;0,93
3529005;Marília;2019;822;3,57;618;2,69;204;0,89
3529104;Marinópolis;2010;0;0;0;0;0;0
3529104;Marinópolis;2011;0;0;0;0;0;0
3529104;Marinópolis;2012;0;0;0;0;0;0
3529104;Marinópolis;2013;0;0;0;0;0;0
3529104;Marinópolis;2014;0;0;0;0;0;0
3529104;Marinópolis;2015;0;0;0;0;0;0
3529104;Marinópolis;2016;0;0;0;0;0;0
3529104;Marinópolis;2017;0;0;0;0;0;0
3529104;Marinópolis;2018;0;0;0;0;0;0
3529104;Marinópolis;2019;0;0;0;0;0;0
3529203;Martinópolis;2010;66;2,73;41;1,69;25;1,03
3529203;Martinópolis;2011;66;2,71;41;1,68;25;1,03
3529203;Martinópolis;2012;66;2,69;41;1,67;25;1,02
3529203;Martinópolis;2013;66;2,68;41;1,66;25;1,01
3529203;Martinópolis;2014;66;2,66;41;1,65;25;1,01
3529203;Martinópolis;2015;51;2,04;43;1,72;8;0,32
3529203;Martinópolis;2016;51;2,03;43;1,71;8;0,32
3529203;Martinópolis;2017;36;1,43;27;1,07;9;0,36
3529203;Martinópolis;2018;35;1,38;30;1,18;5;0,2
3529203;Martinópolis;2019;35;1,37;30;1,18;5;0,2
3529302;Matão;2010;140;1,82;84;1,09;56;0,73
3529302;Matão;2011;140;1,82;84;1,09;56;0,73
3529302;Matão;2012;164;2,12;96;1,24;68;0,88
3529302;Matão;2013;164;2,11;96;1,23;68;0,87
3529302;Matão;2014;169;2,16;101;1,29;68;0,87
3529302;Matão;2015;162;2,06;96;1,22;66;0,84
3529302;Matão;2016;162;2,05;96;1,22;66;0,84
3529302;Matão;2017;162;2,05;96;1,21;66;0,83
3529302;Matão;2018;162;2,04;92;1,16;70;0,88
3529302;Matão;2019;162;2,03;96;1,2;66;0,83
3529401;Mauá;2010;442;1,06;236;0,57;206;0,49
3529401;Mauá;2011;442;1,05;236;0,56;206;0,49
3529401;Mauá;2012;512;1,2;236;0,55;276;0,65
3529401;Mauá;2013;576;1,34;292;0,68;284;0,66
3529401;Mauá;2014;592;1,36;316;0,73;276;0,63
3529401;Mauá;2015;415;0,94;272;0,62;143;0,33
3529401;Mauá;2016;445;1;302;0,68;143;0,32
3529401;Mauá;2017;401;0,9;246;0,55;155;0,35
3529401;Mauá;2018;401;0,89;246;0,54;155;0,34
3529401;Mauá;2019;402;0,88;189;0,41;213;0,47
3529500;Mendonça;2010;0;0;0;0;0;0
3529500;Mendonça;2011;0;0;0;0;0;0
3529500;Mendonça;2012;0;0;0;0;0;0
3529500;Mendonça;2013;0;0;0;0;0;0
3529500;Mendonça;2014;0;0;0;0;0;0
3529500;Mendonça;2015;0;0;0;0;0;0
3529500;Mendonça;2016;0;0;0;0;0;0
3529500;Mendonça;2017;0;0;0;0;0;0
3529500;Mendonça;2018;0;0;0;0;0;0
3529500;Mendonça;2019;0;0;0;0;0;0
3529609;Meridiano;2010;0;0;0;0;0;0
3529609;Meridiano;2011;0;0;0;0;0;0
3529609;Meridiano;2012;0;0;0;0;0;0
3529609;Meridiano;2013;0;0;0;0;0;0
3529609;Meridiano;2014;0;0;0;0;0;0
3529609;Meridiano;2015;0;0;0;0;0;0
3529609;Meridiano;2016;0;0;0;0;0;0
3529609;Meridiano;2017;0;0;0;0;0;0
3529609;Meridiano;2018;0;0;0;0;0;0
3529609;Meridiano;2019;0;0;0;0;0;0
3529658;Mesópolis;2010;0;0;0;0;0;0
3529658;Mesópolis;2011;0;0;0;0;0;0
3529658;Mesópolis;2012;0;0;0;0;0;0
3529658;Mesópolis;2013;0;0;0;0;0;0
3529658;Mesópolis;2014;0;0;0;0;0;0
3529658;Mesópolis;2015;0;0;0;0;0;0
3529658;Mesópolis;2016;0;0;0;0;0;0
3529658;Mesópolis;2017;0;0;0;0;0;0
3529658;Mesópolis;2018;0;0;0;0;0;0
3529658;Mesópolis;2019;0;0;0;0;0;0
3529708;Miguelópolis;2010;64;3,13;43;2,1;21;1,03
3529708;Miguelópolis;2011;64;3,12;43;2,09;21;1,02
3529708;Miguelópolis;2012;66;3,2;47;2,28;19;0,92
3529708;Miguelópolis;2013;66;3,18;47;2,26;19;0,92
3529708;Miguelópolis;2014;66;3,16;47;2,25;19;0,91
3529708;Miguelópolis;2015;66;3,15;47;2,24;19;0,91
3529708;Miguelópolis;2016;66;3,13;47;2,23;19;0,9
3529708;Miguelópolis;2017;66;3,12;47;2,22;19;0,9
3529708;Miguelópolis;2018;66;3,11;47;2,21;19;0,89
3529708;Miguelópolis;2019;66;3,09;47;2,2;19;0,89
3529807;Mineiros do Tietê;2010;0;0;0;0;0;0
3529807;Mineiros do Tietê;2011;0;0;0;0;0;0
3529807;Mineiros do Tietê;2012;0;0;0;0;0;0
3529807;Mineiros do Tietê;2013;0;0;0;0;0;0
3529807;Mineiros do Tietê;2014;0;0;0;0;0;0
3529807;Mineiros do Tietê;2015;0;0;0;0;0;0
3529807;Mineiros do Tietê;2016;0;0;0;0;0;0
3529807;Mineiros do Tietê;2017;0;0;0;0;0;0
3529807;Mineiros do Tietê;2018;5;0,4;5;0,4;0;0
3529807;Mineiros do Tietê;2019;11;0,88;11;0,88;0;0
3530003;Mira Estrela;2010;0;0;0;0;0;0
3530003;Mira Estrela;2011;0;0;0;0;0;0
3530003;Mira Estrela;2012;0;0;0;0;0;0
3530003;Mira Estrela;2013;0;0;0;0;0;0
3530003;Mira Estrela;2014;0;0;0;0;0;0
3530003;Mira Estrela;2015;0;0;0;0;0;0
3530003;Mira Estrela;2016;0;0;0;0;0;0
3530003;Mira Estrela;2017;0;0;0;0;0;0
3530003;Mira Estrela;2018;0;0;0;0;0;0
3530003;Mira Estrela;2019;0;0;0;0;0;0
3529906;Miracatu;2010;16;0,78;16;0,78;0;0
3529906;Miracatu;2011;16;0,78;16;0,78;0;0
3529906;Miracatu;2012;16;0,79;16;0,79;0;0
3529906;Miracatu;2013;0;0;0;0;0;0
3529906;Miracatu;2014;0;0;0;0;0;0
3529906;Miracatu;2015;0;0;0;0;0;0
3529906;Miracatu;2016;0;0;0;0;0;0
3529906;Miracatu;2017;0;0;0;0;0;0
3529906;Miracatu;2018;0;0;0;0;0;0
3529906;Miracatu;2019;0;0;0;0;0;0
3530102;Mirandópolis;2010;126;4,59;96;3,49;30;1,09
3530102;Mirandópolis;2011;126;4,57;96;3,48;30;1,09
3530102;Mirandópolis;2012;126;4,54;96;3,46;30;1,08
3530102;Mirandópolis;2013;96;3,45;96;3,45;0;0
3530102;Mirandópolis;2014;90;3,21;90;3,21;0;0
3530102;Mirandópolis;2015;90;3,2;90;3,2;0;0
3530102;Mirandópolis;2016;90;3,19;90;3,19;0;0
3530102;Mirandópolis;2017;67;2,36;61;2,15;6;0,21
3530102;Mirandópolis;2018;68;2,39;68;2,39;0;0
3530102;Mirandópolis;2019;68;2,38;68;2,38;0;0
3530201;Mirante do Paranapanema;2010;0;0;0;0;0;0
3530201;Mirante do Paranapanema;2011;0;0;0;0;0;0
3530201;Mirante do Paranapanema;2012;0;0;0;0;0;0
3530201;Mirante do Paranapanema;2013;0;0;0;0;0;0
3530201;Mirante do Paranapanema;2014;0;0;0;0;0;0
3530201;Mirante do Paranapanema;2015;0;0;0;0;0;0
3530201;Mirante do Paranapanema;2016;0;0;0;0;0;0
3530201;Mirante do Paranapanema;2017;0;0;0;0;0;0
3530201;Mirante do Paranapanema;2018;0;0;0;0;0;0
3530201;Mirante do Paranapanema;2019;0;0;0;0;0;0
3530300;Mirassol;2010;93;1,73;24;0,45;69;1,28
3530300;Mirassol;2011;93;1,72;24;0,44;69;1,27
3530300;Mirassol;2012;93;1,7;24;0,44;69;1,26
3530300;Mirassol;2013;93;1,69;29;0,53;64;1,16
3530300;Mirassol;2014;93;1,68;29;0,52;64;1,15
3530300;Mirassol;2015;81;1,45;29;0,52;52;0,93
3530300;Mirassol;2016;78;1,39;29;0,51;49;0,87
3530300;Mirassol;2017;78;1,38;29;0,51;49;0,86
3530300;Mirassol;2018;81;1,42;30;0,53;51;0,89
3530300;Mirassol;2019;81;1,41;30;0,52;51;0,89
3530409;Mirassolândia;2010;0;0;0;0;0;0
3530409;Mirassolândia;2011;0;0;0;0;0;0
3530409;Mirassolândia;2012;0;0;0;0;0;0
3530409;Mirassolândia;2013;0;0;0;0;0;0
3530409;Mirassolândia;2014;0;0;0;0;0;0
3530409;Mirassolândia;2015;0;0;0;0;0;0
3530409;Mirassolândia;2016;0;0;0;0;0;0
3530409;Mirassolândia;2017;0;0;0;0;0;0
3530409;Mirassolândia;2018;0;0;0;0;0;0
3530409;Mirassolândia;2019;0;0;0;0;0;0
3530508;Mococa;2010;135;2,04;98;1,48;37;0,56
3530508;Mococa;2011;140;2,11;98;1,48;42;0,63
3530508;Mococa;2012;140;2,11;98;1,48;42;0,63
3530508;Mococa;2013;135;2,03;86;1,29;49;0,74
3530508;Mococa;2014;135;2,03;86;1,29;49;0,74
3530508;Mococa;2015;135;2,03;86;1,29;49;0,74
3530508;Mococa;2016;135;2,03;86;1,29;49;0,74
3530508;Mococa;2017;135;2,03;86;1,29;49;0,74
3530508;Mococa;2018;135;2,03;88;1,32;47;0,71
3530508;Mococa;2019;135;2,02;88;1,32;47;0,7
3530607;Mogi das Cruzes;2010;787;2,03;556;1,44;231;0,6
3530607;Mogi das Cruzes;2011;742;1,89;551;1,41;191;0,49
3530607;Mogi das Cruzes;2012;736;1,86;561;1,41;175;0,44
3530607;Mogi das Cruzes;2013;736;1,83;561;1,4;175;0,44
3530607;Mogi das Cruzes;2014;832;2,05;607;1,5;225;0,55
3530607;Mogi das Cruzes;2015;828;2,02;650;1,58;178;0,43
3530607;Mogi das Cruzes;2016;759;1,83;636;1,53;123;0,3
3530607;Mogi das Cruzes;2017;763;1,82;601;1,43;162;0,39
3530607;Mogi das Cruzes;2018;898;2,12;601;1,42;297;0,7
3530607;Mogi das Cruzes;2019;896;2,09;600;1,4;296;0,69
3530706;Mogi Guaçu;2010;269;1,96;149;1,09;120;0,88
3530706;Mogi Guaçu;2011;269;1,95;149;1,08;120;0,87
3530706;Mogi Guaçu;2012;329;2,36;149;1,07;180;1,29
3530706;Mogi Guaçu;2013;328;2,33;149;1,06;179;1,27
3530706;Mogi Guaçu;2014;333;2,35;154;1,09;179;1,26
3530706;Mogi Guaçu;2015;333;2,33;154;1,08;179;1,25
3530706;Mogi Guaçu;2016;333;2,31;154;1,07;179;1,24
3530706;Mogi Guaçu;2017;333;2,29;154;1,06;179;1,23
3530706;Mogi Guaçu;2018;333;2,28;154;1,05;179;1,22
3530706;Mogi Guaçu;2019;333;2,26;141;0,96;192;1,3
3530805;Mogi Mirim;2010;227;2,63;138;1,6;89;1,03
3530805;Mogi Mirim;2011;264;3,04;140;1,61;124;1,43
3530805;Mogi Mirim;2012;264;3,02;140;1,6;124;1,42
3530805;Mogi Mirim;2013;268;3,05;140;1,59;128;1,46
3530805;Mogi Mirim;2014;254;2,88;131;1,48;123;1,39
3530805;Mogi Mirim;2015;241;2,72;133;1,5;108;1,22
3530805;Mogi Mirim;2016;225;2,53;123;1,38;102;1,15
3530805;Mogi Mirim;2017;213;2,38;114;1,28;99;1,11
3530805;Mogi Mirim;2018;213;2,37;114;1,27;99;1,1
3530805;Mogi Mirim;2019;213;2,36;114;1,27;99;1,1
3530904;Mombuca;2010;0;0;0;0;0;0
3530904;Mombuca;2011;0;0;0;0;0;0
3530904;Mombuca;2012;0;0;0;0;0;0
3530904;Mombuca;2013;0;0;0;0;0;0
3530904;Mombuca;2014;0;0;0;0;0;0
3530904;Mombuca;2015;0;0;0;0;0;0
3530904;Mombuca;2016;0;0;0;0;0;0
3530904;Mombuca;2017;0;0;0;0;0;0
3530904;Mombuca;2018;0;0;0;0;0;0
3530904;Mombuca;2019;0;0;0;0;0;0
3531100;Mongaguá;2010;44;0,95;44;0,95;0;0
3531100;Mongaguá;2011;44;0,94;44;0,94;0;0
3531100;Mongaguá;2012;44;0,92;44;0,92;0;0
3531100;Mongaguá;2013;44;0,9;44;0,9;0;0
3531100;Mongaguá;2014;44;0,89;44;0,89;0;0
3531100;Mongaguá;2015;44;0,87;44;0,87;0;0
3531100;Mongaguá;2016;44;0,86;44;0,86;0;0
3531100;Mongaguá;2017;48;0,92;48;0,92;0;0
3531100;Mongaguá;2018;48;0,91;48;0,91;0;0
3531100;Mongaguá;2019;36;0,67;36;0,67;0;0
3531209;Monte Alegre do Sul;2010;0;0;0;0;0;0
3531209;Monte Alegre do Sul;2011;0;0;0;0;0;0
3531209;Monte Alegre do Sul;2012;0;0;0;0;0;0
3531209;Monte Alegre do Sul;2013;0;0;0;0;0;0
3531209;Monte Alegre do Sul;2014;0;0;0;0;0;0
3531209;Monte Alegre do Sul;2015;0;0;0;0;0;0
3531209;Monte Alegre do Sul;2016;0;0;0;0;0;0
3531209;Monte Alegre do Sul;2017;0;0;0;0;0;0
3531209;Monte Alegre do Sul;2018;0;0;0;0;0;0
3531209;Monte Alegre do Sul;2019;0;0;0;0;0;0
3531308;Monte Alto;2010;104;2,23;57;1,22;47;1,01
3531308;Monte Alto;2011;109;2,33;58;1,24;51;1,09
3531308;Monte Alto;2012;109;2,32;58;1,23;51;1,08
3531308;Monte Alto;2013;109;2,31;58;1,23;51;1,08
3531308;Monte Alto;2014;109;2,3;58;1,22;51;1,07
3531308;Monte Alto;2015;109;2,29;58;1,22;51;1,07
3531308;Monte Alto;2016;109;2,28;58;1,21;51;1,07
3531308;Monte Alto;2017;109;2,27;58;1,21;51;1,06
3531308;Monte Alto;2018;109;2,27;58;1,21;51;1,06
3531308;Monte Alto;2019;109;2,26;58;1,2;51;1,06
3531407;Monte Aprazível;2010;80;3,68;35;1,61;45;2,07
3531407;Monte Aprazível;2011;80;3,65;35;1,6;45;2,05
3531407;Monte Aprazível;2012;80;3,61;35;1,58;45;2,03
3531407;Monte Aprazível;2013;80;3,58;35;1,57;45;2,01
3531407;Monte Aprazível;2014;80;3,55;30;1,33;50;2,22
3531407;Monte Aprazível;2015;80;3,51;31;1,36;49;2,15
3531407;Monte Aprazível;2016;80;3,49;30;1,31;50;2,18
3531407;Monte Aprazível;2017;80;3,47;30;1,3;50;2,17
3531407;Monte Aprazível;2018;80;3,45;30;1,29;50;2,16
3531407;Monte Aprazível;2019;80;3,43;30;1,29;50;2,14
3531506;Monte Azul Paulista;2010;71;3,75;48;2,53;23;1,21
3531506;Monte Azul Paulista;2011;67;3,55;47;2,49;20;1,06
3531506;Monte Azul Paulista;2012;70;3,73;49;2,61;21;1,12
3531506;Monte Azul Paulista;2013;70;3,74;51;2,73;19;1,02
3531506;Monte Azul Paulista;2014;70;3,76;51;2,74;19;1,02
3531506;Monte Azul Paulista;2015;70;3,77;51;2,75;19;1,02
3531506;Monte Azul Paulista;2016;70;3,79;51;2,76;19;1,03
3531506;Monte Azul Paulista;2017;70;3,8;51;2,77;19;1,03
3531506;Monte Azul Paulista;2018;70;3,82;51;2,78;19;1,04
3531506;Monte Azul Paulista;2019;70;3,83;51;2,79;19;1,04
3531605;Monte Castelo;2010;0;0;0;0;0;0
3531605;Monte Castelo;2011;0;0;0;0;0;0
3531605;Monte Castelo;2012;0;0;0;0;0;0
3531605;Monte Castelo;2013;0;0;0;0;0;0
3531605;Monte Castelo;2014;0;0;0;0;0;0
3531605;Monte Castelo;2015;0;0;0;0;0;0
3531605;Monte Castelo;2016;0;0;0;0;0;0
3531605;Monte Castelo;2017;0;0;0;0;0;0
3531605;Monte Castelo;2018;0;0;0;0;0;0
3531605;Monte Castelo;2019;0;0;0;0;0;0
3531803;Monte Mor;2010;45;0,92;38;0,78;7;0,14
3531803;Monte Mor;2011;45;0,9;38;0,76;7;0,14
3531803;Monte Mor;2012;45;0,88;38;0,75;7;0,14
3531803;Monte Mor;2013;36;0,69;29;0,56;7;0,13
3531803;Monte Mor;2014;36;0,68;29;0,55;7;0,13
3531803;Monte Mor;2015;36;0,66;29;0,53;7;0,13
3531803;Monte Mor;2016;36;0,65;29;0,52;7;0,13
3531803;Monte Mor;2017;35;0,62;26;0,46;9;0,16
3531803;Monte Mor;2018;35;0,61;26;0,45;9;0,16
3531803;Monte Mor;2019;35;0,6;26;0,44;9;0,15
3531704;Monteiro Lobato;2010;0;0;0;0;0;0
3531704;Monteiro Lobato;2011;0;0;0;0;0;0
3531704;Monteiro Lobato;2012;0;0;0;0;0;0
3531704;Monteiro Lobato;2013;0;0;0;0;0;0
3531704;Monteiro Lobato;2014;0;0;0;0;0;0
3531704;Monteiro Lobato;2015;0;0;0;0;0;0
3531704;Monteiro Lobato;2016;0;0;0;0;0;0
3531704;Monteiro Lobato;2017;0;0;0;0;0;0
3531704;Monteiro Lobato;2018;0;0;0;0;0;0
3531704;Monteiro Lobato;2019;0;0;0;0;0;0
3531001;Monções;2010;0;0;0;0;0;0
3531001;Monções;2011;0;0;0;0;0;0
3531001;Monções;2012;0;0;0;0;0;0
3531001;Monções;2013;0;0;0;0;0;0
3531001;Monções;2014;0;0;0;0;0;0
3531001;Monções;2015;0;0;0;0;0;0
3531001;Monções;2016;0;0;0;0;0;0
3531001;Monções;2017;0;0;0;0;0;0
3531001;Monções;2018;0;0;0;0;0;0
3531001;Monções;2019;0;0;0;0;0;0
3531902;Morro Agudo;2010;45;1,55;31;1,07;14;0,48
3531902;Morro Agudo;2011;45;1,53;31;1,05;14;0,48
3531902;Morro Agudo;2012;45;1,51;31;1,04;14;0,47
3531902;Morro Agudo;2013;45;1,5;31;1,03;14;0,47
3531902;Morro Agudo;2014;45;1,48;31;1,02;14;0,46
3531902;Morro Agudo;2015;45;1,46;31;1,01;14;0,46
3531902;Morro Agudo;2016;45;1,45;31;1;14;0,45
3531902;Morro Agudo;2017;45;1,43;31;0,99;14;0,45
3531902;Morro Agudo;2018;45;1,42;31;0,98;14;0,44
3531902;Morro Agudo;2019;45;1,41;31;0,97;14;0,44
3532009;Morungaba;2010;27;2,3;17;1,45;10;0,85
3532009;Morungaba;2011;40;3,36;30;2,52;10;0,84
3532009;Morungaba;2012;42;3,48;13;1,08;29;2,4
3532009;Morungaba;2013;13;1,06;13;1,06;0;0
3532009;Morungaba;2014;13;1,05;13;1,05;0;0
3532009;Morungaba;2015;23;1,83;13;1,04;10;0,8
3532009;Morungaba;2016;20;1,58;10;0,79;10;0,79
3532009;Morungaba;2017;20;1,56;10;0,78;10;0,78
3532009;Morungaba;2018;19;1,47;9;0,69;10;0,77
3532009;Morungaba;2019;19;1,45;9;0,69;10;0,76
3532058;Motuca;2010;0;0;0;0;0;0
3532058;Motuca;2011;0;0;0;0;0;0
3532058;Motuca;2012;0;0;0;0;0;0
3532058;Motuca;2013;0;0;0;0;0;0
3532058;Motuca;2014;0;0;0;0;0;0
3532058;Motuca;2015;0;0;0;0;0;0
3532058;Motuca;2016;0;0;0;0;0;0
3532058;Motuca;2017;0;0;0;0;0;0
3532058;Motuca;2018;0;0;0;0;0;0
3532058;Motuca;2019;0;0;0;0;0;0
3532108;Murutinga do Sul;2010;22;5,26;22;5,26;0;0
3532108;Murutinga do Sul;2011;22;5,24;22;5,24;0;0
3532108;Murutinga do Sul;2012;22;5,23;22;5,23;0;0
3532108;Murutinga do Sul;2013;0;0;0;0;0;0
3532108;Murutinga do Sul;2014;0;0;0;0;0;0
3532108;Murutinga do Sul;2015;0;0;0;0;0;0
3532108;Murutinga do Sul;2016;0;0;0;0;0;0
3532108;Murutinga do Sul;2017;0;0;0;0;0;0
3532108;Murutinga do Sul;2018;0;0;0;0;0;0
3532108;Murutinga do Sul;2019;0;0;0;0;0;0
3532157;Nantes;2010;0;0;0;0;0;0
3532157;Nantes;2011;0;0;0;0;0;0
3532157;Nantes;2012;0;0;0;0;0;0
3532157;Nantes;2013;0;0;0;0;0;0
3532157;Nantes;2014;0;0;0;0;0;0
3532157;Nantes;2015;0;0;0;0;0;0
3532157;Nantes;2016;0;0;0;0;0;0
3532157;Nantes;2017;0;0;0;0;0;0
3532157;Nantes;2018;0;0;0;0;0;0
3532157;Nantes;2019;0;0;0;0;0;0
3532207;Narandiba;2010;0;0;0;0;0;0
3532207;Narandiba;2011;0;0;0;0;0;0
3532207;Narandiba;2012;0;0;0;0;0;0
3532207;Narandiba;2013;0;0;0;0;0;0
3532207;Narandiba;2014;0;0;0;0;0;0
3532207;Narandiba;2015;0;0;0;0;0;0
3532207;Narandiba;2016;0;0;0;0;0;0
3532207;Narandiba;2017;0;0;0;0;0;0
3532207;Narandiba;2018;0;0;0;0;0;0
3532207;Narandiba;2019;0;0;0;0;0;0
3532306;Natividade da Serra;2010;0;0;0;0;0;0
3532306;Natividade da Serra;2011;0;0;0;0;0;0
3532306;Natividade da Serra;2012;0;0;0;0;0;0
3532306;Natividade da Serra;2013;0;0;0;0;0;0
3532306;Natividade da Serra;2014;0;0;0;0;0;0
3532306;Natividade da Serra;2015;0;0;0;0;0;0
3532306;Natividade da Serra;2016;0;0;0;0;0;0
3532306;Natividade da Serra;2017;0;0;0;0;0;0
3532306;Natividade da Serra;2018;0;0;0;0;0;0
3532306;Natividade da Serra;2019;0;0;0;0;0;0
3532405;Nazaré Paulista;2010;24;1,46;24;1,46;0;0
3532405;Nazaré Paulista;2011;24;1,45;24;1,45;0;0
3532405;Nazaré Paulista;2012;24;1,43;24;1,43;0;0
3532405;Nazaré Paulista;2013;24;1,41;24;1,41;0;0
3532405;Nazaré Paulista;2014;24;1,39;24;1,39;0;0
3532405;Nazaré Paulista;2015;24;1,38;24;1,38;0;0
3532405;Nazaré Paulista;2016;24;1,36;24;1,36;0;0
3532405;Nazaré Paulista;2017;20;1,12;20;1,12;0;0
3532405;Nazaré Paulista;2018;20;1,11;20;1,11;0;0
3532405;Nazaré Paulista;2019;20;1,1;20;1,1;0;0
3532504;Neves Paulista;2010;34;3,88;11;1,25;23;2,62
3532504;Neves Paulista;2011;34;3,88;11;1,26;23;2,62
3532504;Neves Paulista;2012;34;3,89;11;1,26;23;2,63
3532504;Neves Paulista;2013;35;4,01;11;1,26;24;2,75
3532504;Neves Paulista;2014;35;4,01;11;1,26;24;2,75
3532504;Neves Paulista;2015;35;4,02;11;1,26;24;2,75
3532504;Neves Paulista;2016;35;4,02;11;1,26;24;2,76
3532504;Neves Paulista;2017;21;2,42;10;1,15;11;1,27
3532504;Neves Paulista;2018;21;2,43;10;1,15;11;1,27
3532504;Neves Paulista;2019;21;2,43;10;1,16;11;1,27
3532603;Nhandeara;2010;124;11,57;36;3,36;88;8,21
3532603;Nhandeara;2011;124;11,55;36;3,35;88;8,2
3532603;Nhandeara;2012;124;11,53;36;3,35;88;8,19
3532603;Nhandeara;2013;129;11,98;36;3,34;93;8,64
3532603;Nhandeara;2014;129;11,97;37;3,43;92;8,53
3532603;Nhandeara;2015;129;11,95;35;3,24;94;8,71
3532603;Nhandeara;2016;129;11,95;35;3,24;94;8,71
3532603;Nhandeara;2017;129;11,96;35;3,24;94;8,71
3532603;Nhandeara;2018;129;11,96;35;3,24;94;8,71
3532603;Nhandeara;2019;129;11,96;35;3,25;94;8,72
3532702;Nipoã;2010;0;0;0;0;0;0
3532702;Nipoã;2011;0;0;0;0;0;0
3532702;Nipoã;2012;0;0;0;0;0;0
3532702;Nipoã;2013;0;0;0;0;0;0
3532702;Nipoã;2014;0;0;0;0;0;0
3532702;Nipoã;2015;0;0;0;0;0;0
3532702;Nipoã;2016;0;0;0;0;0;0
3532702;Nipoã;2017;0;0;0;0;0;0
3532702;Nipoã;2018;0;0;0;0;0;0
3532702;Nipoã;2019;0;0;0;0;0;0
3532801;Nova Aliança;2010;0;0;0;0;0;0
3532801;Nova Aliança;2011;0;0;0;0;0;0
3532801;Nova Aliança;2012;0;0;0;0;0;0
3532801;Nova Aliança;2013;0;0;0;0;0;0
3532801;Nova Aliança;2014;0;0;0;0;0;0
3532801;Nova Aliança;2015;0;0;0;0;0;0
3532801;Nova Aliança;2016;0;0;0;0;0;0
3532801;Nova Aliança;2017;0;0;0;0;0;0
3532801;Nova Aliança;2018;0;0;0;0;0;0
3532801;Nova Aliança;2019;0;0;0;0;0;0
3532827;Nova Campina;2010;0;0;0;0;0;0
3532827;Nova Campina;2011;0;0;0;0;0;0
3532827;Nova Campina;2012;0;0;0;0;0;0
3532827;Nova Campina;2013;0;0;0;0;0;0
3532827;Nova Campina;2014;0;0;0;0;0;0
3532827;Nova Campina;2015;0;0;0;0;0;0
3532827;Nova Campina;2016;0;0;0;0;0;0
3532827;Nova Campina;2017;0;0;0;0;0;0
3532827;Nova Campina;2018;0;0;0;0;0;0
3532827;Nova Campina;2019;0;0;0;0;0;0
3532843;Nova Canaã Paulista;2010;0;0;0;0;0;0
3532843;Nova Canaã Paulista;2011;0;0;0;0;0;0
3532843;Nova Canaã Paulista;2012;0;0;0;0;0;0
3532843;Nova Canaã Paulista;2013;0;0;0;0;0;0
3532843;Nova Canaã Paulista;2014;0;0;0;0;0;0
3532843;Nova Canaã Paulista;2015;0;0;0;0;0;0
3532843;Nova Canaã Paulista;2016;0;0;0;0;0;0
3532843;Nova Canaã Paulista;2017;0;0;0;0;0;0
3532843;Nova Canaã Paulista;2018;0;0;0;0;0;0
3532843;Nova Canaã Paulista;2019;0;0;0;0;0;0
3532868;Nova Castilho;2010;0;0;0;0;0;0
3532868;Nova Castilho;2011;0;0;0;0;0;0
3532868;Nova Castilho;2012;0;0;0;0;0;0
3532868;Nova Castilho;2013;0;0;0;0;0;0
3532868;Nova Castilho;2014;0;0;0;0;0;0
3532868;Nova Castilho;2015;0;0;0;0;0;0
3532868;Nova Castilho;2016;0;0;0;0;0;0
3532868;Nova Castilho;2017;0;0;0;0;0;0
3532868;Nova Castilho;2018;0;0;0;0;0;0
3532868;Nova Castilho;2019;0;0;0;0;0;0
3532900;Nova Europa;2010;12;1,29;7;0,75;5;0,54
3532900;Nova Europa;2011;12;1,27;7;0,74;5;0,53
3532900;Nova Europa;2012;12;1,25;7;0,73;5;0,52
3532900;Nova Europa;2013;12;1,23;7;0,72;5;0,51
3532900;Nova Europa;2014;12;1,21;7;0,71;5;0,51
3532900;Nova Europa;2015;12;1,19;7;0,7;5;0,5
3532900;Nova Europa;2016;12;1,18;7;0,69;5;0,49
3532900;Nova Europa;2017;12;1,16;7;0,68;5;0,48
3532900;Nova Europa;2018;12;1,15;7;0,67;5;0,48
3532900;Nova Europa;2019;12;1,13;7;0,66;5;0,47
3533007;Nova Granada;2010;193;10,07;42;2,19;151;7,88
3533007;Nova Granada;2011;193;9,98;42;2,17;151;7,81
3533007;Nova Granada;2012;193;9,89;42;2,15;151;7,73
3533007;Nova Granada;2013;193;9,79;42;2,13;151;7,66
3533007;Nova Granada;2014;193;9,7;37;1,86;156;7,84
3533007;Nova Granada;2015;193;9,61;19;0,95;174;8,67
3533007;Nova Granada;2016;193;9,53;19;0,94;174;8,59
3533007;Nova Granada;2017;62;3,04;19;0,93;43;2,11
3533007;Nova Granada;2018;62;3,01;19;0,92;43;2,09
3533007;Nova Granada;2019;62;2,99;19;0,92;43;2,07
3533106;Nova Guataporanga;2010;0;0;0;0;0;0
3533106;Nova Guataporanga;2011;0;0;0;0;0;0
3533106;Nova Guataporanga;2012;0;0;0;0;0;0
3533106;Nova Guataporanga;2013;0;0;0;0;0;0
3533106;Nova Guataporanga;2014;0;0;0;0;0;0
3533106;Nova Guataporanga;2015;0;0;0;0;0;0
3533106;Nova Guataporanga;2016;0;0;0;0;0;0
3533106;Nova Guataporanga;2017;0;0;0;0;0;0
3533106;Nova Guataporanga;2018;0;0;0;0;0;0
3533106;Nova Guataporanga;2019;0;0;0;0;0;0
3533205;Nova Independência;2010;0;0;0;0;0;0
3533205;Nova Independência;2011;0;0;0;0;0;0
3533205;Nova Independência;2012;0;0;0;0;0;0
3533205;Nova Independência;2013;0;0;0;0;0;0
3533205;Nova Independência;2014;0;0;0;0;0;0
3533205;Nova Independência;2015;0;0;0;0;0;0
3533205;Nova Independência;2016;0;0;0;0;0;0
3533205;Nova Independência;2017;0;0;0;0;0;0
3533205;Nova Independência;2018;0;0;0;0;0;0
3533205;Nova Independência;2019;0;0;0;0;0;0
3533304;Nova Luzitânia;2010;0;0;0;0;0;0
3533304;Nova Luzitânia;2011;0;0;0;0;0;0
3533304;Nova Luzitânia;2012;0;0;0;0;0;0
3533304;Nova Luzitânia;2013;0;0;0;0;0;0
3533304;Nova Luzitânia;2014;0;0;0;0;0;0
3533304;Nova Luzitânia;2015;0;0;0;0;0;0
3533304;Nova Luzitânia;2016;0;0;0;0;0;0
3533304;Nova Luzitânia;2017;0;0;0;0;0;0
3533304;Nova Luzitânia;2018;0;0;0;0;0;0
3533304;Nova Luzitânia;2019;0;0;0;0;0;0
3533403;Nova Odessa;2010;50;0,98;50;0,98;0;0
3533403;Nova Odessa;2011;50;0,96;50;0,96;0;0
3533403;Nova Odessa;2012;53;1,01;53;1,01;0;0
3533403;Nova Odessa;2013;53;0,99;53;0,99;0;0
3533403;Nova Odessa;2014;53;0,98;53;0,98;0;0
3533403;Nova Odessa;2015;53;0,97;53;0,97;0;0
3533403;Nova Odessa;2016;53;0,95;53;0,95;0;0
3533403;Nova Odessa;2017;53;0,94;53;0,94;0;0
3533403;Nova Odessa;2018;53;0,93;53;0,93;0;0
3533403;Nova Odessa;2019;53;0,92;53;0,92;0;0
3533254;Novais;2010;0;0;0;0;0;0
3533254;Novais;2011;0;0;0;0;0;0
3533254;Novais;2012;0;0;0;0;0;0
3533254;Novais;2013;0;0;0;0;0;0
3533254;Novais;2014;0;0;0;0;0;0
3533254;Novais;2015;0;0;0;0;0;0
3533254;Novais;2016;0;0;0;0;0;0
3533254;Novais;2017;0;0;0;0;0;0
3533254;Novais;2018;0;0;0;0;0;0
3533254;Novais;2019;0;0;0;0;0;0
3533502;Novo Horizonte;2010;105;2,87;38;1,04;67;1,83
3533502;Novo Horizonte;2011;105;2,85;38;1,03;67;1,82
3533502;Novo Horizonte;2012;105;2,83;38;1,03;67;1,81
3533502;Novo Horizonte;2013;105;2,81;38;1,02;67;1,8
3533502;Novo Horizonte;2014;105;2,79;35;0,93;70;1,86
3533502;Novo Horizonte;2015;105;2,77;35;0,92;70;1,85
3533502;Novo Horizonte;2016;105;2,76;35;0,92;70;1,84
3533502;Novo Horizonte;2017;105;2,74;35;0,91;70;1,83
3533502;Novo Horizonte;2018;105;2,73;35;0,91;70;1,82
3533502;Novo Horizonte;2019;105;2,71;35;0,9;70;1,81
3533601;Nuporanga;2010;0;0;0;0;0;0
3533601;Nuporanga;2011;0;0;0;0;0;0
3533601;Nuporanga;2012;0;0;0;0;0;0
3533601;Nuporanga;2013;0;0;0;0;0;0
3533601;Nuporanga;2014;0;0;0;0;0;0
3533601;Nuporanga;2015;0;0;0;0;0;0
3533601;Nuporanga;2016;0;0;0;0;0;0
3533601;Nuporanga;2017;0;0;0;0;0;0
3533601;Nuporanga;2018;0;0;0;0;0;0
3533601;Nuporanga;2019;0;0;0;0;0;0
3533700;Ocauçu;2010;0;0;0;0;0;0
3533700;Ocauçu;2011;0;0;0;0;0;0
3533700;Ocauçu;2012;0;0;0;0;0;0
3533700;Ocauçu;2013;0;0;0;0;0;0
3533700;Ocauçu;2014;0;0;0;0;0;0
3533700;Ocauçu;2015;0;0;0;0;0;0
3533700;Ocauçu;2016;0;0;0;0;0;0
3533700;Ocauçu;2017;0;0;0;0;0;0
3533700;Ocauçu;2018;0;0;0;0;0;0
3533700;Ocauçu;2019;0;0;0;0;0;0
3533809;Óleo;2010;0;0;0;0;0;0
3533809;Óleo;2011;0;0;0;0;0;0
3533809;Óleo;2012;0;0;0;0;0;0
3533809;Óleo;2013;0;0;0;0;0;0
3533809;Óleo;2014;0;0;0;0;0;0
3533809;Óleo;2015;0;0;0;0;0;0
3533809;Óleo;2016;0;0;0;0;0;0
3533809;Óleo;2017;0;0;0;0;0;0
3533809;Óleo;2018;0;0;0;0;0;0
3533809;Óleo;2019;0;0;0;0;0;0
3533908;Olímpia;2010;94;1,88;76;1,52;18;0,36
3533908;Olímpia;2011;94;1,87;76;1,51;18;0,36
3533908;Olímpia;2012;94;1,86;76;1,5;18;0,36
3533908;Olímpia;2013;98;1,93;80;1,57;18;0,35
3533908;Olímpia;2014;99;1,94;79;1,55;20;0,39
3533908;Olímpia;2015;99;1,93;63;1,23;36;0,7
3533908;Olímpia;2016;99;1,92;63;1,22;36;0,7
3533908;Olímpia;2017;99;1,91;60;1,16;39;0,75
3533908;Olímpia;2018;79;1,52;42;0,81;37;0,71
3533908;Olímpia;2019;79;1,51;42;0,8;37;0,71
3534005;Onda Verde;2010;0;0;0;0;0;0
3534005;Onda Verde;2011;0;0;0;0;0;0
3534005;Onda Verde;2012;0;0;0;0;0;0
3534005;Onda Verde;2013;0;0;0;0;0;0
3534005;Onda Verde;2014;0;0;0;0;0;0
3534005;Onda Verde;2015;0;0;0;0;0;0
3534005;Onda Verde;2016;0;0;0;0;0;0
3534005;Onda Verde;2017;0;0;0;0;0;0
3534005;Onda Verde;2018;0;0;0;0;0;0
3534005;Onda Verde;2019;0;0;0;0;0;0
3534104;Oriente;2010;0;0;0;0;0;0
3534104;Oriente;2011;0;0;0;0;0;0
3534104;Oriente;2012;0;0;0;0;0;0
3534104;Oriente;2013;0;0;0;0;0;0
3534104;Oriente;2014;0;0;0;0;0;0
3534104;Oriente;2015;0;0;0;0;0;0
3534104;Oriente;2016;0;0;0;0;0;0
3534104;Oriente;2017;0;0;0;0;0;0
3534104;Oriente;2018;0;0;0;0;0;0
3534104;Oriente;2019;0;0;0;0;0;0
3534203;Orindiúva;2010;0;0;0;0;0;0
3534203;Orindiúva;2011;0;0;0;0;0;0
3534203;Orindiúva;2012;0;0;0;0;0;0
3534203;Orindiúva;2013;0;0;0;0;0;0
3534203;Orindiúva;2014;0;0;0;0;0;0
3534203;Orindiúva;2015;0;0;0;0;0;0
3534203;Orindiúva;2016;0;0;0;0;0;0
3534203;Orindiúva;2017;0;0;0;0;0;0
3534203;Orindiúva;2018;0;0;0;0;0;0
3534203;Orindiúva;2019;0;0;0;0;0;0
3534302;Orlândia;2010;118;2,97;72;1,81;46;1,16
3534302;Orlândia;2011;118;2,95;72;1,8;46;1,15
3534302;Orlândia;2012;118;2,93;72;1,79;46;1,14
3534302;Orlândia;2013;98;2,42;59;1,45;39;0,96
3534302;Orlândia;2014;98;2,4;59;1,44;39;0,96
3534302;Orlândia;2015;98;2,38;59;1,44;39;0,95
3534302;Orlândia;2016;98;2,37;59;1,43;39;0,94
3534302;Orlândia;2017;98;2,36;59;1,42;39;0,94
3534302;Orlândia;2018;98;2,34;60;1,44;38;0,91
3534302;Orlândia;2019;98;2,33;60;1,43;38;0,9
3534401;Osasco;2010;910;1,37;509;0,76;401;0,6
3534401;Osasco;2011;950;1,42;616;0,92;334;0,5
3534401;Osasco;2012;909;1,36;599;0,9;310;0,46
3534401;Osasco;2013;1009;1,51;593;0,88;416;0,62
3534401;Osasco;2014;992;1,48;592;0,88;400;0,6
3534401;Osasco;2015;1008;1,5;605;0,9;403;0,6
3534401;Osasco;2016;1006;1,49;604;0,9;402;0,6
3534401;Osasco;2017;1000;1,48;591;0,87;409;0,6
3534401;Osasco;2018;916;1,35;589;0,87;327;0,48
3534401;Osasco;2019;878;1,29;578;0,85;300;0,44
3534500;Oscar Bressane;2010;0;0;0;0;0;0
3534500;Oscar Bressane;2011;0;0;0;0;0;0
3534500;Oscar Bressane;2012;0;0;0;0;0;0
3534500;Oscar Bressane;2013;0;0;0;0;0;0
3534500;Oscar Bressane;2014;0;0;0;0;0;0
3534500;Oscar Bressane;2015;0;0;0;0;0;0
3534500;Oscar Bressane;2016;0;0;0;0;0;0
3534500;Oscar Bressane;2017;0;0;0;0;0;0
3534500;Oscar Bressane;2018;0;0;0;0;0;0
3534500;Oscar Bressane;2019;0;0;0;0;0;0
3534609;Osvaldo Cruz;2010;118;3,82;71;2,3;47;1,52
3534609;Osvaldo Cruz;2011;118;3,81;71;2,29;47;1,52
3534609;Osvaldo Cruz;2012;118;3,81;71;2,29;47;1,52
3534609;Osvaldo Cruz;2013;90;2,9;59;1,9;31;1
3534609;Osvaldo Cruz;2014;90;2,9;59;1,9;31;1
3534609;Osvaldo Cruz;2015;90;2,89;59;1,9;31;1
3534609;Osvaldo Cruz;2016;90;2,89;59;1,89;31;0,99
3534609;Osvaldo Cruz;2017;73;2,34;59;1,89;14;0,45
3534609;Osvaldo Cruz;2018;73;2,34;59;1,89;14;0,45
3534609;Osvaldo Cruz;2019;77;2,47;53;1,7;24;0,77
3534708;Ourinhos;2010;296;2,88;221;2,15;75;0,73
3534708;Ourinhos;2011;315;3,04;230;2,22;85;0,82
3534708;Ourinhos;2012;315;3,01;230;2,2;85;0,81
3534708;Ourinhos;2013;315;2,99;230;2,18;85;0,81
3534708;Ourinhos;2014;315;2,97;230;2,17;85;0,8
3534708;Ourinhos;2015;328;3,07;143;1,34;185;1,73
3534708;Ourinhos;2016;185;1,72;83;0,77;102;0,95
3534708;Ourinhos;2017;169;1,56;83;0,77;86;0,79
3534708;Ourinhos;2018;166;1,52;83;0,76;83;0,76
3534708;Ourinhos;2019;166;1,51;83;0,76;83;0,76
3534807;Ouro Verde;2010;0;0;0;0;0;0
3534807;Ouro Verde;2011;0;0;0;0;0;0
3534807;Ouro Verde;2012;0;0;0;0;0;0
3534807;Ouro Verde;2013;0;0;0;0;0;0
3534807;Ouro Verde;2014;0;0;0;0;0;0
3534807;Ouro Verde;2015;0;0;0;0;0;0
3534807;Ouro Verde;2016;0;0;0;0;0;0
3534807;Ouro Verde;2017;0;0;0;0;0;0
3534807;Ouro Verde;2018;0;0;0;0;0;0
3534807;Ouro Verde;2019;0;0;0;0;0;0
3534757;Ouroeste;2010;39;4,65;10;1,19;29;3,46
3534757;Ouroeste;2011;39;4,57;10;1,17;29;3,4
3534757;Ouroeste;2012;39;4,49;10;1,15;29;3,34
3534757;Ouroeste;2013;39;4,42;10;1,13;29;3,29
3534757;Ouroeste;2014;39;4,34;10;1,11;29;3,23
3534757;Ouroeste;2015;39;4,27;10;1,09;29;3,17
3534757;Ouroeste;2016;33;3,56;28;3,02;5;0,54
3534757;Ouroeste;2017;33;3,52;28;2,98;5;0,53
3534757;Ouroeste;2018;33;3,47;28;2,94;5;0,53
3534757;Ouroeste;2019;33;3,42;28;2,9;5;0,52
3534906;Pacaembu;2010;32;2,42;29;2,19;3;0,23
3534906;Pacaembu;2011;32;2,42;29;2,2;3;0,23
3534906;Pacaembu;2012;32;2,43;29;2,2;3;0,23
3534906;Pacaembu;2013;37;2,81;29;2,2;8;0,61
3534906;Pacaembu;2014;37;2,81;32;2,43;5;0,38
3534906;Pacaembu;2015;37;2,82;32;2,44;5;0,38
3534906;Pacaembu;2016;37;2,82;32;2,44;5;0,38
3534906;Pacaembu;2017;37;2,82;32;2,44;5;0,38
3534906;Pacaembu;2018;37;2,83;32;2,44;5;0,38
3534906;Pacaembu;2019;37;2,83;32;2,45;5;0,38
3535002;Palestina;2010;0;0;0;0;0;0
3535002;Palestina;2011;0;0;0;0;0;0
3535002;Palestina;2012;0;0;0;0;0;0
3535002;Palestina;2013;0;0;0;0;0;0
3535002;Palestina;2014;0;0;0;0;0;0
3535002;Palestina;2015;0;0;0;0;0;0
3535002;Palestina;2016;0;0;0;0;0;0
3535002;Palestina;2017;0;0;0;0;0;0
3535002;Palestina;2018;0;0;0;0;0;0
3535002;Palestina;2019;0;0;0;0;0;0
3535101;Palmares Paulista;2010;0;0;0;0;0;0
3535101;Palmares Paulista;2011;0;0;0;0;0;0
3535101;Palmares Paulista;2012;0;0;0;0;0;0
3535101;Palmares Paulista;2013;0;0;0;0;0;0
3535101;Palmares Paulista;2014;0;0;0;0;0;0
3535101;Palmares Paulista;2015;0;0;0;0;0;0
3535101;Palmares Paulista;2016;0;0;0;0;0;0
3535101;Palmares Paulista;2017;0;0;0;0;0;0
3535101;Palmares Paulista;2018;0;0;0;0;0;0
3535101;Palmares Paulista;2019;0;0;0;0;0;0
3535200;Palmeira d'Oeste;2010;24;2,5;10;1,04;14;1,46
3535200;Palmeira d'Oeste;2011;24;2,52;10;1,05;14;1,47
3535200;Palmeira d'Oeste;2012;24;2,53;10;1,06;14;1,48
3535200;Palmeira d'Oeste;2013;24;2,55;10;1,06;14;1,49
3535200;Palmeira d'Oeste;2014;24;2,56;10;1,07;14;1,49
3535200;Palmeira d'Oeste;2015;24;2,58;10;1,07;14;1,5
3535200;Palmeira d'Oeste;2016;20;2,16;9;0,97;11;1,19
3535200;Palmeira d'Oeste;2017;20;2,16;10;1,08;10;1,08
3535200;Palmeira d'Oeste;2018;20;2,17;10;1,09;10;1,09
3535200;Palmeira d'Oeste;2019;20;2,18;10;1,09;10;1,09
3535309;Palmital;2010;68;3,21;44;2,08;24;1,13
3535309;Palmital;2011;68;3,2;44;2,07;24;1,13
3535309;Palmital;2012;68;3,2;44;2,07;24;1,13
3535309;Palmital;2013;68;3,19;44;2,06;24;1,13
3535309;Palmital;2014;68;3,18;44;2,06;24;1,12
3535309;Palmital;2015;68;3,18;44;2,06;24;1,12
3535309;Palmital;2016;68;3,17;44;2,05;24;1,12
3535309;Palmital;2017;54;2,51;36;1,68;18;0,84
3535309;Palmital;2018;54;2,51;36;1,67;18;0,84
3535309;Palmital;2019;54;2,5;36;1,67;18;0,83
3535408;Panorama;2010;65;4,46;45;3,09;20;1,37
3535408;Panorama;2011;65;4,44;45;3,07;20;1,37
3535408;Panorama;2012;65;4,42;45;3,06;20;1,36
3535408;Panorama;2013;65;4,4;45;3,05;20;1,35
3535408;Panorama;2014;36;2,43;35;2,36;1;0,07
3535408;Panorama;2015;36;2,42;35;2,35;1;0,07
3535408;Panorama;2016;36;2,41;35;2,34;1;0,07
3535408;Panorama;2017;36;2,4;35;2,33;1;0,07
3535408;Panorama;2018;36;2,39;35;2,32;1;0,07
3535408;Panorama;2019;36;2,38;35;2,31;1;0,07
3535507;Paraguaçu Paulista;2010;97;2,3;78;1,85;19;0,45
3535507;Paraguaçu Paulista;2011;97;2,28;78;1,84;19;0,45
3535507;Paraguaçu Paulista;2012;97;2,27;78;1,83;19;0,45
3535507;Paraguaçu Paulista;2013;97;2,26;78;1,82;19;0,44
3535507;Paraguaçu Paulista;2014;97;2,25;78;1,81;19;0,44
3535507;Paraguaçu Paulista;2015;97;2,24;78;1,8;19;0,44
3535507;Paraguaçu Paulista;2016;97;2,23;78;1,8;19;0,44
3535507;Paraguaçu Paulista;2017;97;2,22;78;1,79;19;0,44
3535507;Paraguaçu Paulista;2018;97;2,21;78;1,78;19;0,43
3535507;Paraguaçu Paulista;2019;97;2,2;78;1,77;19;0,43
3535606;Paraibuna;2010;24;1,38;11;0,63;13;0,75
3535606;Paraibuna;2011;14;0,8;12;0,69;2;0,11
3535606;Paraibuna;2012;14;0,8;12;0,68;2;0,11
3535606;Paraibuna;2013;14;0,79;12;0,68;2;0,11
3535606;Paraibuna;2014;14;0,79;12;0,68;2;0,11
3535606;Paraibuna;2015;0;0;0;0;0;0
3535606;Paraibuna;2016;0;0;0;0;0;0
3535606;Paraibuna;2017;0;0;0;0;0;0
3535606;Paraibuna;2018;0;0;0;0;0;0
3535606;Paraibuna;2019;0;0;0;0;0;0
3535705;Paraíso;2010;0;0;0;0;0;0
3535705;Paraíso;2011;0;0;0;0;0;0
3535705;Paraíso;2012;0;0;0;0;0;0
3535705;Paraíso;2013;0;0;0;0;0;0
3535705;Paraíso;2014;0;0;0;0;0;0
3535705;Paraíso;2015;0;0;0;0;0;0
3535705;Paraíso;2016;0;0;0;0;0;0
3535705;Paraíso;2017;0;0;0;0;0;0
3535705;Paraíso;2018;0;0;0;0;0;0
3535705;Paraíso;2019;0;0;0;0;0;0
3535804;Paranapanema;2010;30;1,69;30;1,69;0;0
3535804;Paranapanema;2011;30;1,67;30;1,67;0;0
3535804;Paranapanema;2012;30;1,65;30;1,65;0;0
3535804;Paranapanema;2013;30;1,63;30;1,63;0;0
3535804;Paranapanema;2014;30;1,61;30;1,61;0;0
3535804;Paranapanema;2015;30;1,59;30;1,59;0;0
3535804;Paranapanema;2016;30;1,57;30;1,57;0;0
3535804;Paranapanema;2017;30;1,55;30;1,55;0;0
3535804;Paranapanema;2018;30;1,54;30;1,54;0;0
3535804;Paranapanema;2019;30;1,52;30;1,52;0;0
3535903;Paranapuã;2010;0;0;0;0;0;0
3535903;Paranapuã;2011;0;0;0;0;0;0
3535903;Paranapuã;2012;0;0;0;0;0;0
3535903;Paranapuã;2013;0;0;0;0;0;0
3535903;Paranapuã;2014;0;0;0;0;0;0
3535903;Paranapuã;2015;0;0;0;0;0;0
3535903;Paranapuã;2016;0;0;0;0;0;0
3535903;Paranapuã;2017;0;0;0;0;0;0
3535903;Paranapuã;2018;0;0;0;0;0;0
3535903;Paranapuã;2019;0;0;0;0;0;0
3536000;Parapuã;2010;32;2,95;26;2,4;6;0,55
3536000;Parapuã;2011;32;2,96;26;2,41;6;0,56
3536000;Parapuã;2012;32;2,97;26;2,41;6;0,56
3536000;Parapuã;2013;32;2,98;26;2,42;6;0,56
3536000;Parapuã;2014;32;2,99;26;2,43;6;0,56
3536000;Parapuã;2015;32;3;26;2,44;6;0,56
3536000;Parapuã;2016;32;3,01;26;2,45;6;0,56
3536000;Parapuã;2017;32;3,02;26;2,45;6;0,57
3536000;Parapuã;2018;32;3,03;26;2,46;6;0,57
3536000;Parapuã;2019;32;3,04;26;2,47;6;0,57
3536109;Pardinho;2010;0;0;0;0;0;0
3536109;Pardinho;2011;0;0;0;0;0;0
3536109;Pardinho;2012;0;0;0;0;0;0
3536109;Pardinho;2013;0;0;0;0;0;0
3536109;Pardinho;2014;0;0;0;0;0;0
3536109;Pardinho;2015;0;0;0;0;0;0
3536109;Pardinho;2016;0;0;0;0;0;0
3536109;Pardinho;2017;0;0;0;0;0;0
3536109;Pardinho;2018;0;0;0;0;0;0
3536109;Pardinho;2019;0;0;0;0;0;0
3536208;Pariquera-Açu;2010;159;8,62;159;8,62;0;0
3536208;Pariquera-Açu;2011;159;8,58;159;8,58;0;0
3536208;Pariquera-Açu;2012;152;8,17;152;8,17;0;0
3536208;Pariquera-Açu;2013;152;8,13;152;8,13;0;0
3536208;Pariquera-Açu;2014;151;8,04;151;8,04;0;0
3536208;Pariquera-Açu;2015;151;8,01;151;8,01;0;0
3536208;Pariquera-Açu;2016;151;7,97;151;7,97;0;0
3536208;Pariquera-Açu;2017;149;7,84;149;7,84;0;0
3536208;Pariquera-Açu;2018;150;7,86;150;7,86;0;0
3536208;Pariquera-Açu;2019;150;7,82;150;7,82;0;0
3536257;Parisi;2010;0;0;0;0;0;0
3536257;Parisi;2011;0;0;0;0;0;0
3536257;Parisi;2012;0;0;0;0;0;0
3536257;Parisi;2013;0;0;0;0;0;0
3536257;Parisi;2014;0;0;0;0;0;0
3536257;Parisi;2015;0;0;0;0;0;0
3536257;Parisi;2016;0;0;0;0;0;0
3536257;Parisi;2017;0;0;0;0;0;0
3536257;Parisi;2018;0;0;0;0;0;0
3536257;Parisi;2019;0;0;0;0;0;0
3536307;Patrocínio Paulista;2010;35;2,7;23;1,77;12;0,92
3536307;Patrocínio Paulista;2011;35;2,66;23;1,75;12;0,91
3536307;Patrocínio Paulista;2012;35;2,63;23;1,73;12;0,9
3536307;Patrocínio Paulista;2013;35;2,6;23;1,71;12;0,89
3536307;Patrocínio Paulista;2014;35;2,57;23;1,69;12;0,88
3536307;Patrocínio Paulista;2015;35;2,55;23;1,67;12;0,87
3536307;Patrocínio Paulista;2016;35;2,52;23;1,66;12;0,86
3536307;Patrocínio Paulista;2017;35;2,49;23;1,64;12;0,86
3536307;Patrocínio Paulista;2018;35;2,47;23;1,62;12;0,85
3536307;Patrocínio Paulista;2019;35;2,44;23;1,61;12;0,84
3536406;Paulicéia;2010;0;0;0;0;0;0
3536406;Paulicéia;2011;0;0;0;0;0;0
3536406;Paulicéia;2012;0;0;0;0;0;0
3536406;Paulicéia;2013;0;0;0;0;0;0
3536406;Paulicéia;2014;0;0;0;0;0;0
3536406;Paulicéia;2015;0;0;0;0;0;0
3536406;Paulicéia;2016;0;0;0;0;0;0
3536406;Paulicéia;2017;0;0;0;0;0;0
3536406;Paulicéia;2018;0;0;0;0;0;0
3536406;Paulicéia;2019;0;0;0;0;0;0
3536505;Paulínia;2010;102;1,25;84;1,03;18;0,22
3536505;Paulínia;2011;84;1;84;1;0;0
3536505;Paulínia;2012;84;0,97;84;0,97;0;0
3536505;Paulínia;2013;84;0,94;84;0,94;0;0
3536505;Paulínia;2014;84;0,91;84;0,91;0;0
3536505;Paulínia;2015;85;0,89;85;0,89;0;0
3536505;Paulínia;2016;85;0,88;85;0,88;0;0
3536505;Paulínia;2017;85;0,86;85;0,86;0;0
3536505;Paulínia;2018;85;0,84;85;0,84;0;0
3536505;Paulínia;2019;97;0,94;97;0,94;0;0
3536570;Paulistânia;2010;0;0;0;0;0;0
3536570;Paulistânia;2011;0;0;0;0;0;0
3536570;Paulistânia;2012;0;0;0;0;0;0
3536570;Paulistânia;2013;0;0;0;0;0;0
3536570;Paulistânia;2014;0;0;0;0;0;0
3536570;Paulistânia;2015;0;0;0;0;0;0
3536570;Paulistânia;2016;0;0;0;0;0;0
3536570;Paulistânia;2017;0;0;0;0;0;0
3536570;Paulistânia;2018;0;0;0;0;0;0
3536570;Paulistânia;2019;0;0;0;0;0;0
3536604;Paulo de Faria;2010;24;2,79;9;1,05;15;1,75
3536604;Paulo de Faria;2011;24;2,8;9;1,05;15;1,75
3536604;Paulo de Faria;2012;24;2,8;9;1,05;15;1,75
3536604;Paulo de Faria;2013;24;2,8;9;1,05;15;1,75
3536604;Paulo de Faria;2014;24;2,81;4;0,47;20;2,34
3536604;Paulo de Faria;2015;24;2,81;9;1,05;15;1,76
3536604;Paulo de Faria;2016;24;2,81;9;1,05;15;1,76
3536604;Paulo de Faria;2017;24;2,81;9;1,05;15;1,76
3536604;Paulo de Faria;2018;24;2,81;18;2,11;6;0,7
3536604;Paulo de Faria;2019;24;2,82;18;2,11;6;0,7
3536703;Pederneiras;2010;67;1,62;47;1,13;20;0,48
3536703;Pederneiras;2011;67;1,6;47;1,12;20;0,48
3536703;Pederneiras;2012;72;1,7;52;1,23;20;0,47
3536703;Pederneiras;2013;72;1,68;52;1,22;20;0,47
3536703;Pederneiras;2014;72;1,67;52;1,2;20;0,46
3536703;Pederneiras;2015;72;1,65;52;1,19;20;0,46
3536703;Pederneiras;2016;72;1,64;52;1,18;20;0,45
3536703;Pederneiras;2017;72;1,62;52;1,17;20;0,45
3536703;Pederneiras;2018;72;1,61;52;1,16;20;0,45
3536703;Pederneiras;2019;72;1,59;52;1,15;20;0,44
3536802;Pedra Bela;2010;0;0;0;0;0;0
3536802;Pedra Bela;2011;0;0;0;0;0;0
3536802;Pedra Bela;2012;0;0;0;0;0;0
3536802;Pedra Bela;2013;0;0;0;0;0;0
3536802;Pedra Bela;2014;0;0;0;0;0;0
3536802;Pedra Bela;2015;0;0;0;0;0;0
3536802;Pedra Bela;2016;0;0;0;0;0;0
3536802;Pedra Bela;2017;0;0;0;0;0;0
3536802;Pedra Bela;2018;0;0;0;0;0;0
3536802;Pedra Bela;2019;0;0;0;0;0;0
3536901;Pedranópolis;2010;0;0;0;0;0;0
3536901;Pedranópolis;2011;0;0;0;0;0;0
3536901;Pedranópolis;2012;0;0;0;0;0;0
3536901;Pedranópolis;2013;0;0;0;0;0;0
3536901;Pedranópolis;2014;0;0;0;0;0;0
3536901;Pedranópolis;2015;0;0;0;0;0;0
3536901;Pedranópolis;2016;0;0;0;0;0;0
3536901;Pedranópolis;2017;0;0;0;0;0;0
3536901;Pedranópolis;2018;0;0;0;0;0;0
3536901;Pedranópolis;2019;0;0;0;0;0;0
3537008;Pedregulho;2010;51;3,25;38;2,42;13;0,83
3537008;Pedregulho;2011;52;3,3;32;2,03;20;1,27
3537008;Pedregulho;2012;53;3,35;33;2,09;20;1,26
3537008;Pedregulho;2013;53;3,34;33;2,08;20;1,26
3537008;Pedregulho;2014;53;3,32;33;2,07;20;1,25
3537008;Pedregulho;2015;53;3,31;33;2,06;20;1,25
3537008;Pedregulho;2016;75;4,67;55;3,43;20;1,25
3537008;Pedregulho;2017;75;4,65;55;3,41;20;1,24
3537008;Pedregulho;2018;82;5,07;59;3,65;23;1,42
3537008;Pedregulho;2019;64;3,95;55;3,39;9;0,55
3537107;Pedreira;2010;49;1,18;39;0,94;10;0,24
3537107;Pedreira;2011;49;1,17;39;0,93;10;0,24
3537107;Pedreira;2012;49;1,15;39;0,92;10;0,23
3537107;Pedreira;2013;98;2,27;88;2,04;10;0,23
3537107;Pedreira;2014;49;1,12;49;1,12;0;0
3537107;Pedreira;2015;98;2,21;98;2,21;0;0
3537107;Pedreira;2016;98;2,19;98;2,19;0;0
3537107;Pedreira;2017;98;2,17;98;2,17;0;0
3537107;Pedreira;2018;98;2,15;98;2,15;0;0
3537107;Pedreira;2019;98;2,13;98;2,13;0;0
3537156;Pedrinhas Paulista;2010;0;0;0;0;0;0
3537156;Pedrinhas Paulista;2011;0;0;0;0;0;0
3537156;Pedrinhas Paulista;2012;0;0;0;0;0;0
3537156;Pedrinhas Paulista;2013;0;0;0;0;0;0
3537156;Pedrinhas Paulista;2014;0;0;0;0;0;0
3537156;Pedrinhas Paulista;2015;0;0;0;0;0;0
3537156;Pedrinhas Paulista;2016;0;0;0;0;0;0
3537156;Pedrinhas Paulista;2017;0;0;0;0;0;0
3537156;Pedrinhas Paulista;2018;0;0;0;0;0;0
3537156;Pedrinhas Paulista;2019;0;0;0;0;0;0
3537206;Pedro de Toledo;2010;0;0;0;0;0;0
3537206;Pedro de Toledo;2011;0;0;0;0;0;0
3537206;Pedro de Toledo;2012;0;0;0;0;0;0
3537206;Pedro de Toledo;2013;0;0;0;0;0;0
3537206;Pedro de Toledo;2014;0;0;0;0;0;0
3537206;Pedro de Toledo;2015;0;0;0;0;0;0
3537206;Pedro de Toledo;2016;0;0;0;0;0;0
3537206;Pedro de Toledo;2017;0;0;0;0;0;0
3537206;Pedro de Toledo;2018;0;0;0;0;0;0
3537206;Pedro de Toledo;2019;0;0;0;0;0;0
3537305;Penápolis;2010;245;4,19;172;2,94;73;1,25
3537305;Penápolis;2011;241;4,1;168;2,86;73;1,24
3537305;Penápolis;2012;238;4,04;168;2,85;70;1,19
3537305;Penápolis;2013;238;4,02;168;2,84;70;1,18
3537305;Penápolis;2014;238;4;168;2,82;70;1,18
3537305;Penápolis;2015;238;3,98;168;2,81;70;1,17
3537305;Penápolis;2016;220;3,67;150;2,5;70;1,17
3537305;Penápolis;2017;254;4,22;175;2,91;79;1,31
3537305;Penápolis;2018;254;4,21;175;2,9;79;1,31
3537305;Penápolis;2019;200;3,3;173;2,86;27;0,45
3537404;Pereira Barreto;2010;98;3,93;65;2,6;33;1,32
3537404;Pereira Barreto;2011;98;3,92;65;2,6;33;1,32
3537404;Pereira Barreto;2012;98;3,91;65;2,59;33;1,32
3537404;Pereira Barreto;2013;98;3,9;65;2,59;33;1,31
3537404;Pereira Barreto;2014;98;3,9;65;2,58;33;1,31
3537404;Pereira Barreto;2015;104;4,13;71;2,82;33;1,31
3537404;Pereira Barreto;2016;92;3,65;62;2,46;30;1,19
3537404;Pereira Barreto;2017;52;2,06;47;1,86;5;0,2
3537404;Pereira Barreto;2018;52;2,05;47;1,86;5;0,2
3537404;Pereira Barreto;2019;52;2,05;47;1,85;5;0,2
3537503;Pereiras;2010;0;0;0;0;0;0
3537503;Pereiras;2011;0;0;0;0;0;0
3537503;Pereiras;2012;0;0;0;0;0;0
3537503;Pereiras;2013;0;0;0;0;0;0
3537503;Pereiras;2014;0;0;0;0;0;0
3537503;Pereiras;2015;0;0;0;0;0;0
3537503;Pereiras;2016;0;0;0;0;0;0
3537503;Pereiras;2017;0;0;0;0;0;0
3537503;Pereiras;2018;0;0;0;0;0;0
3537503;Pereiras;2019;0;0;0;0;0;0
3537602;Peruíbe;2010;44;0,74;44;0,74;0;0
3537602;Peruíbe;2011;43;0,71;43;0,71;0;0
3537602;Peruíbe;2012;39;0,64;39;0,64;0;0
3537602;Peruíbe;2013;39;0,63;39;0,63;0;0
3537602;Peruíbe;2014;39;0,63;39;0,63;0;0
3537602;Peruíbe;2015;0;0;0;0;0;0
3537602;Peruíbe;2016;0;0;0;0;0;0
3537602;Peruíbe;2017;14;0,22;14;0,22;0;0
3537602;Peruíbe;2018;14;0,22;14;0,22;0;0
3537602;Peruíbe;2019;14;0,21;14;0,21;0;0
3537701;Piacatu;2010;0;0;0;0;0;0
3537701;Piacatu;2011;0;0;0;0;0;0
3537701;Piacatu;2012;0;0;0;0;0;0
3537701;Piacatu;2013;0;0;0;0;0;0
3537701;Piacatu;2014;0;0;0;0;0;0
3537701;Piacatu;2015;0;0;0;0;0;0
3537701;Piacatu;2016;0;0;0;0;0;0
3537701;Piacatu;2017;0;0;0;0;0;0
3537701;Piacatu;2018;0;0;0;0;0;0
3537701;Piacatu;2019;0;0;0;0;0;0
3537800;Piedade;2010;515;9,88;511;9,8;4;0,08
3537800;Piedade;2011;515;9,86;511;9,78;4;0,08
3537800;Piedade;2012;515;9,83;471;8,99;44;0,84
3537800;Piedade;2013;521;9,92;471;8,97;50;0,95
3537800;Piedade;2014;521;9,9;471;8,95;50;0,95
3537800;Piedade;2015;521;9,87;471;8,92;50;0,95
3537800;Piedade;2016;525;9,92;406;7,67;119;2,25
3537800;Piedade;2017;290;5,46;258;4,86;32;0,6
3537800;Piedade;2018;290;5,45;258;4,85;32;0,6
3537800;Piedade;2019;60;1,12;50;0,94;10;0,19
3537909;Pilar do Sul;2010;35;1,33;27;1,02;8;0,3
3537909;Pilar do Sul;2011;35;1,32;27;1,02;8;0,3
3537909;Pilar do Sul;2012;35;1,31;27;1,01;8;0,3
3537909;Pilar do Sul;2013;35;1,3;27;1;8;0,3
3537909;Pilar do Sul;2014;35;1,29;27;0,99;8;0,29
3537909;Pilar do Sul;2015;35;1,28;27;0,99;8;0,29
3537909;Pilar do Sul;2016;35;1,27;27;0,98;8;0,29
3537909;Pilar do Sul;2017;35;1,26;27;0,98;8;0,29
3537909;Pilar do Sul;2018;35;1,26;27;0,97;8;0,29
3537909;Pilar do Sul;2019;35;1,25;27;0,96;8;0,29
3538006;Pindamonhangaba;2010;204;1,39;122;0,83;82;0,56
3538006;Pindamonhangaba;2011;195;1,31;117;0,79;78;0,52
3538006;Pindamonhangaba;2012;170;1,13;117;0,78;53;0,35
3538006;Pindamonhangaba;2013;210;1,38;134;0,88;76;0,5
3538006;Pindamonhangaba;2014;199;1,29;127;0,82;72;0,47
3538006;Pindamonhangaba;2015;201;1,29;127;0,81;74;0,47
3538006;Pindamonhangaba;2016;201;1,28;127;0,81;74;0,47
3538006;Pindamonhangaba;2017;201;1,26;127;0,8;74;0,47
3538006;Pindamonhangaba;2018;201;1,25;127;0,79;74;0,46
3538006;Pindamonhangaba;2019;254;1,57;127;0,78;127;0,78
3538105;Pindorama;2010;0;0;0;0;0;0
3538105;Pindorama;2011;0;0;0;0;0;0
3538105;Pindorama;2012;0;0;0;0;0;0
3538105;Pindorama;2013;0;0;0;0;0;0
3538105;Pindorama;2014;0;0;0;0;0;0
3538105;Pindorama;2015;0;0;0;0;0;0
3538105;Pindorama;2016;0;0;0;0;0;0
3538105;Pindorama;2017;0;0;0;0;0;0
3538105;Pindorama;2018;0;0;0;0;0;0
3538105;Pindorama;2019;0;0;0;0;0;0
3538204;Pinhalzinho;2010;0;0;0;0;0;0
3538204;Pinhalzinho;2011;0;0;0;0;0;0
3538204;Pinhalzinho;2012;0;0;0;0;0;0
3538204;Pinhalzinho;2013;0;0;0;0;0;0
3538204;Pinhalzinho;2014;0;0;0;0;0;0
3538204;Pinhalzinho;2015;0;0;0;0;0;0
3538204;Pinhalzinho;2016;0;0;0;0;0;0
3538204;Pinhalzinho;2017;0;0;0;0;0;0
3538204;Pinhalzinho;2018;0;0;0;0;0;0
3538204;Pinhalzinho;2019;0;0;0;0;0;0
3538303;Piquerobi;2010;0;0;0;0;0;0
3538303;Piquerobi;2011;0;0;0;0;0;0
3538303;Piquerobi;2012;0;0;0;0;0;0
3538303;Piquerobi;2013;0;0;0;0;0;0
3538303;Piquerobi;2014;0;0;0;0;0;0
3538303;Piquerobi;2015;0;0;0;0;0;0
3538303;Piquerobi;2016;0;0;0;0;0;0
3538303;Piquerobi;2017;0;0;0;0;0;0
3538303;Piquerobi;2018;0;0;0;0;0;0
3538303;Piquerobi;2019;0;0;0;0;0;0
3538501;Piquete;2010;0;0;0;0;0;0
3538501;Piquete;2011;0;0;0;0;0;0
3538501;Piquete;2012;0;0;0;0;0;0
3538501;Piquete;2013;0;0;0;0;0;0
3538501;Piquete;2014;0;0;0;0;0;0
3538501;Piquete;2015;0;0;0;0;0;0
3538501;Piquete;2016;0;0;0;0;0;0
3538501;Piquete;2017;0;0;0;0;0;0
3538501;Piquete;2018;0;0;0;0;0;0
3538501;Piquete;2019;0;0;0;0;0;0
3538600;Piracaia;2010;35;1,39;25;1;10;0,4
3538600;Piracaia;2011;35;1,39;25;0,99;10;0,4
3538600;Piracaia;2012;37;1,46;29;1,14;8;0,32
3538600;Piracaia;2013;37;1,45;29;1,14;8;0,31
3538600;Piracaia;2014;37;1,45;29;1,13;8;0,31
3538600;Piracaia;2015;37;1,44;29;1,13;8;0,31
3538600;Piracaia;2016;37;1,43;29;1,12;8;0,31
3538600;Piracaia;2017;37;1,43;29;1,12;8;0,31
3538600;Piracaia;2018;37;1,42;29;1,11;8;0,31
3538600;Piracaia;2019;37;1,41;29;1,11;8;0,31
3538709;Piracicaba;2010;683;1,88;293;0,8;390;1,07
3538709;Piracicaba;2011;807;2,2;316;0,86;491;1,34
3538709;Piracicaba;2012;807;2,18;316;0,85;491;1,33
3538709;Piracicaba;2013;815;2,19;312;0,84;503;1,35
3538709;Piracicaba;2014;801;2,13;309;0,82;492;1,31
3538709;Piracicaba;2015;761;2,01;309;0,82;452;1,2
3538709;Piracicaba;2016;704;1,85;315;0,83;389;1,02
3538709;Piracicaba;2017;715;1,87;282;0,74;433;1,13
3538709;Piracicaba;2018;757;1,97;331;0,86;426;1,11
3538709;Piracicaba;2019;711;1,83;331;0,85;380;0,98
3538808;Piraju;2010;80;2,81;71;2,49;9;0,32
3538808;Piraju;2011;80;2,81;71;2,49;9;0,32
3538808;Piraju;2012;80;2,81;71;2,49;9;0,32
3538808;Piraju;2013;80;2,8;71;2,49;9;0,32
3538808;Piraju;2014;72;2,52;54;1,89;18;0,63
3538808;Piraju;2015;73;2,56;55;1,93;18;0,63
3538808;Piraju;2016;77;2,7;58;2,03;19;0,67
3538808;Piraju;2017;77;2,7;58;2,03;19;0,67
3538808;Piraju;2018;77;2,7;58;2,03;19;0,67
3538808;Piraju;2019;77;2,69;58;2,03;19;0,66
3538907;Pirajuí;2010;153;6,75;83;3,66;70;3,09
3538907;Pirajuí;2011;153;6,72;83;3,65;70;3,07
3538907;Pirajuí;2012;303;13,26;293;12,82;10;0,44
3538907;Pirajuí;2013;299;13,04;289;12,6;10;0,44
3538907;Pirajuí;2014;299;12,99;289;12,55;10;0,43
3538907;Pirajuí;2015;299;12,94;289;12,5;10;0,43
3538907;Pirajuí;2016;299;12,92;289;12,49;10;0,43
3538907;Pirajuí;2017;285;12,3;78;3,37;207;8,93
3538907;Pirajuí;2018;299;12,89;78;3,36;221;9,53
3538907;Pirajuí;2019;288;12,4;67;2,88;221;9,51
3539004;Pirangi;2010;37;3,48;9;0,85;28;2,64
3539004;Pirangi;2011;37;3,48;9;0,85;28;2,63
3539004;Pirangi;2012;37;3,47;9;0,84;28;2,62
3539004;Pirangi;2013;37;3,46;9;0,84;28;2,62
3539004;Pirangi;2014;41;3,83;9;0,84;32;2,99
3539004;Pirangi;2015;41;3,82;9;0,84;32;2,98
3539004;Pirangi;2016;41;3,81;9;0,84;32;2,97
3539004;Pirangi;2017;41;3,81;9;0,84;32;2,97
3539004;Pirangi;2018;41;3,8;9;0,83;32;2,97
3539004;Pirangi;2019;41;3,79;9;0,83;32;2,96
3539103;Pirapora do Bom Jesus;2010;0;0;0;0;0;0
3539103;Pirapora do Bom Jesus;2011;0;0;0;0;0;0
3539103;Pirapora do Bom Jesus;2012;0;0;0;0;0;0
3539103;Pirapora do Bom Jesus;2013;0;0;0;0;0;0
3539103;Pirapora do Bom Jesus;2014;0;0;0;0;0;0
3539103;Pirapora do Bom Jesus;2015;0;0;0;0;0;0
3539103;Pirapora do Bom Jesus;2016;0;0;0;0;0;0
3539103;Pirapora do Bom Jesus;2017;0;0;0;0;0;0
3539103;Pirapora do Bom Jesus;2018;0;0;0;0;0;0
3539103;Pirapora do Bom Jesus;2019;0;0;0;0;0;0
3539202;Pirapozinho;2010;59;2,39;59;2,39;0;0
3539202;Pirapozinho;2011;59;2,37;59;2,37;0;0
3539202;Pirapozinho;2012;59;2,34;59;2,34;0;0
3539202;Pirapozinho;2013;59;2,32;59;2,32;0;0
3539202;Pirapozinho;2014;59;2,3;59;2,3;0;0
3539202;Pirapozinho;2015;0;0;0;0;0;0
3539202;Pirapozinho;2016;0;0;0;0;0;0
3539202;Pirapozinho;2017;0;0;0;0;0;0
3539202;Pirapozinho;2018;0;0;0;0;0;0
3539202;Pirapozinho;2019;0;0;0;0;0;0
3539301;Pirassununga;2010;110;1,57;54;0,77;56;0,8
3539301;Pirassununga;2011;86;1,22;52;0,74;34;0,48
3539301;Pirassununga;2012;87;1,23;52;0,73;35;0,49
3539301;Pirassununga;2013;87;1,22;52;0,73;35;0,49
3539301;Pirassununga;2014;91;1,27;55;0,77;36;0,5
3539301;Pirassununga;2015;94;1,31;57;0,79;37;0,51
3539301;Pirassununga;2016;94;1,3;57;0,79;37;0,51
3539301;Pirassununga;2017;151;2,08;57;0,78;94;1,29
3539301;Pirassununga;2018;151;2,07;57;0,78;94;1,29
3539301;Pirassununga;2019;151;2,06;57;0,78;94;1,28
3539400;Piratininga;2010;30;2,49;26;2,16;4;0,33
3539400;Piratininga;2011;30;2,46;26;2,14;4;0,33
3539400;Piratininga;2012;30;2,44;26;2,12;4;0,33
3539400;Piratininga;2013;30;2,42;26;2,09;4;0,32
3539400;Piratininga;2014;30;2,39;26;2,07;4;0,32
3539400;Piratininga;2015;30;2,37;26;2,05;4;0,32
3539400;Piratininga;2016;28;2,19;25;1,96;3;0,24
3539400;Piratininga;2017;28;2,17;25;1,94;3;0,23
3539400;Piratininga;2018;28;2,16;25;1,93;3;0,23
3539400;Piratininga;2019;28;2,14;25;1,91;3;0,23
3539509;Pitangueiras;2010;50;1,42;33;0,94;17;0,48
3539509;Pitangueiras;2011;50;1,4;32;0,9;18;0,51
3539509;Pitangueiras;2012;50;1,39;32;0,89;18;0,5
3539509;Pitangueiras;2013;50;1,38;32;0,88;18;0,5
3539509;Pitangueiras;2014;50;1,36;32;0,87;18;0,49
3539509;Pitangueiras;2015;50;1,35;32;0,87;18;0,49
3539509;Pitangueiras;2016;50;1,34;32;0,86;18;0,48
3539509;Pitangueiras;2017;50;1,33;32;0,85;18;0,48
3539509;Pitangueiras;2018;50;1,32;32;0,84;18;0,47
3539509;Pitangueiras;2019;50;1,31;32;0,84;18;0,47
3539608;Planalto;2010;0;0;0;0;0;0
3539608;Planalto;2011;0;0;0;0;0;0
3539608;Planalto;2012;0;0;0;0;0;0
3539608;Planalto;2013;0;0;0;0;0;0
3539608;Planalto;2014;0;0;0;0;0;0
3539608;Planalto;2015;0;0;0;0;0;0
3539608;Planalto;2016;0;0;0;0;0;0
3539608;Planalto;2017;0;0;0;0;0;0
3539608;Planalto;2018;0;0;0;0;0;0
3539608;Planalto;2019;0;0;0;0;0;0
3539707;Platina;2010;0;0;0;0;0;0
3539707;Platina;2011;0;0;0;0;0;0
3539707;Platina;2012;0;0;0;0;0;0
3539707;Platina;2013;0;0;0;0;0;0
3539707;Platina;2014;0;0;0;0;0;0
3539707;Platina;2015;0;0;0;0;0;0
3539707;Platina;2016;0;0;0;0;0;0
3539707;Platina;2017;0;0;0;0;0;0
3539707;Platina;2018;0;0;0;0;0;0
3539707;Platina;2019;0;0;0;0;0;0
3539806;Poá;2010;24;0,23;24;0,23;0;0
3539806;Poá;2011;14;0,13;14;0,13;0;0
3539806;Poá;2012;21;0,19;21;0,19;0;0
3539806;Poá;2013;21;0,19;21;0,19;0;0
3539806;Poá;2014;30;0,27;30;0,27;0;0
3539806;Poá;2015;33;0,3;33;0,3;0;0
3539806;Poá;2016;35;0,31;35;0,31;0;0
3539806;Poá;2017;35;0,31;35;0,31;0;0
3539806;Poá;2018;35;0,31;35;0,31;0;0
3539806;Poá;2019;36;0,31;36;0,31;0;0
3539905;Poloni;2010;0;0;0;0;0;0
3539905;Poloni;2011;0;0;0;0;0;0
3539905;Poloni;2012;0;0;0;0;0;0
3539905;Poloni;2013;0;0;0;0;0;0
3539905;Poloni;2014;0;0;0;0;0;0
3539905;Poloni;2015;0;0;0;0;0;0
3539905;Poloni;2016;0;0;0;0;0;0
3539905;Poloni;2017;0;0;0;0;0;0
3539905;Poloni;2018;0;0;0;0;0;0
3539905;Poloni;2019;0;0;0;0;0;0
3540002;Pompéia;2010;41;2,06;41;2,06;0;0
3540002;Pompéia;2011;41;2,04;41;2,04;0;0
3540002;Pompéia;2012;41;2,03;41;2,03;0;0
3540002;Pompéia;2013;41;2,01;41;2,01;0;0
3540002;Pompéia;2014;41;2;41;2;0;0
3540002;Pompéia;2015;42;2,03;36;1,74;6;0,29
3540002;Pompéia;2016;42;2,02;36;1,73;6;0,29
3540002;Pompéia;2017;42;2,01;36;1,72;6;0,29
3540002;Pompéia;2018;42;2;36;1,71;6;0,29
3540002;Pompéia;2019;19;0,9;14;0,66;5;0,24
3540101;Pongaí;2010;0;0;0;0;0;0
3540101;Pongaí;2011;0;0;0;0;0;0
3540101;Pongaí;2012;0;0;0;0;0;0
3540101;Pongaí;2013;0;0;0;0;0;0
3540101;Pongaí;2014;0;0;0;0;0;0
3540101;Pongaí;2015;0;0;0;0;0;0
3540101;Pongaí;2016;0;0;0;0;0;0
3540101;Pongaí;2017;0;0;0;0;0;0
3540101;Pongaí;2018;0;0;0;0;0;0
3540101;Pongaí;2019;0;0;0;0;0;0
3540200;Pontal;2010;75;1,87;42;1,05;33;0,82
3540200;Pontal;2011;75;1,82;45;1,09;30;0,73
3540200;Pontal;2012;75;1,78;45;1,07;30;0,71
3540200;Pontal;2013;75;1,74;45;1,04;30;0,69
3540200;Pontal;2014;45;1,02;29;0,66;16;0,36
3540200;Pontal;2015;45;0,99;29;0,64;16;0,35
3540200;Pontal;2016;45;0,98;29;0,63;16;0,35
3540200;Pontal;2017;45;0,96;29;0,62;16;0,34
3540200;Pontal;2018;45;0,94;29;0,61;16;0,34
3540200;Pontal;2019;45;0,93;29;0,6;16;0,33
3540259;Pontalinda;2010;0;0;0;0;0;0
3540259;Pontalinda;2011;0;0;0;0;0;0
3540259;Pontalinda;2012;0;0;0;0;0;0
3540259;Pontalinda;2013;0;0;0;0;0;0
3540259;Pontalinda;2014;0;0;0;0;0;0
3540259;Pontalinda;2015;0;0;0;0;0;0
3540259;Pontalinda;2016;0;0;0;0;0;0
3540259;Pontalinda;2017;0;0;0;0;0;0
3540259;Pontalinda;2018;0;0;0;0;0;0
3540259;Pontalinda;2019;0;0;0;0;0;0
3540309;Pontes Gestal;2010;0;0;0;0;0;0
3540309;Pontes Gestal;2011;0;0;0;0;0;0
3540309;Pontes Gestal;2012;0;0;0;0;0;0
3540309;Pontes Gestal;2013;0;0;0;0;0;0
3540309;Pontes Gestal;2014;0;0;0;0;0;0
3540309;Pontes Gestal;2015;0;0;0;0;0;0
3540309;Pontes Gestal;2016;0;0;0;0;0;0
3540309;Pontes Gestal;2017;0;0;0;0;0;0
3540309;Pontes Gestal;2018;0;0;0;0;0;0
3540309;Pontes Gestal;2019;0;0;0;0;0;0
3540408;Populina;2010;18;4,26;8;1,89;10;2,37
3540408;Populina;2011;18;4,29;8;1,91;10;2,38
3540408;Populina;2012;18;4,31;8;1,92;10;2,4
3540408;Populina;2013;18;4,34;8;1,93;10;2,41
3540408;Populina;2014;18;4,36;6;1,45;12;2,91
3540408;Populina;2015;18;4,39;8;1,95;10;2,44
3540408;Populina;2016;18;4,41;8;1,96;10;2,45
3540408;Populina;2017;18;4,44;8;1,97;10;2,46
3540408;Populina;2018;18;4,46;8;1,98;10;2,48
3540408;Populina;2019;18;4,48;7;1,74;11;2,74
3540507;Porangaba;2010;0;0;0;0;0;0
3540507;Porangaba;2011;0;0;0;0;0;0
3540507;Porangaba;2012;0;0;0;0;0;0
3540507;Porangaba;2013;0;0;0;0;0;0
3540507;Porangaba;2014;0;0;0;0;0;0
3540507;Porangaba;2015;0;0;0;0;0;0
3540507;Porangaba;2016;0;0;0;0;0;0
3540507;Porangaba;2017;0;0;0;0;0;0
3540507;Porangaba;2018;0;0;0;0;0;0
3540507;Porangaba;2019;0;0;0;0;0;0
3540606;Porto Feliz;2010;45;0,92;34;0,7;11;0,23
3540606;Porto Feliz;2011;45;0,92;34;0,69;11;0,22
3540606;Porto Feliz;2012;45;0,91;35;0,71;10;0,2
3540606;Porto Feliz;2013;51;1,03;39;0,78;12;0,24
3540606;Porto Feliz;2014;51;1,02;39;0,78;12;0,24
3540606;Porto Feliz;2015;51;1,01;39;0,77;12;0,24
3540606;Porto Feliz;2016;51;1,01;39;0,77;12;0,24
3540606;Porto Feliz;2017;51;1;39;0,77;12;0,24
3540606;Porto Feliz;2018;51;1;39;0,76;12;0,23
3540606;Porto Feliz;2019;51;0,99;39;0,76;12;0,23
3540705;Porto Ferreira;2010;61;1,19;37;0,72;24;0,47
3540705;Porto Ferreira;2011;61;1,18;37;0,72;24;0,46
3540705;Porto Ferreira;2012;61;1,17;37;0,71;24;0,46
3540705;Porto Ferreira;2013;61;1,17;37;0,71;24;0,46
3540705;Porto Ferreira;2014;61;1,16;37;0,7;24;0,46
3540705;Porto Ferreira;2015;61;1,15;33;0,62;28;0,53
3540705;Porto Ferreira;2016;61;1,15;33;0,62;28;0,53
3540705;Porto Ferreira;2017;61;1,14;33;0,62;28;0,52
3540705;Porto Ferreira;2018;55;1,03;33;0,62;22;0,41
3540705;Porto Ferreira;2019;55;1,02;33;0,61;22;0,41
3540754;Potim;2010;0;0;0;0;0;0
3540754;Potim;2011;0;0;0;0;0;0
3540754;Potim;2012;0;0;0;0;0;0
3540754;Potim;2013;0;0;0;0;0;0
3540754;Potim;2014;0;0;0;0;0;0
3540754;Potim;2015;0;0;0;0;0;0
3540754;Potim;2016;0;0;0;0;0;0
3540754;Potim;2017;0;0;0;0;0;0
3540754;Potim;2018;0;0;0;0;0;0
3540754;Potim;2019;0;0;0;0;0;0
3540804;Potirendaba;2010;28;1,81;20;1,3;8;0,52
3540804;Potirendaba;2011;28;1,8;20;1,29;8;0,51
3540804;Potirendaba;2012;28;1,78;20;1,27;8;0,51
3540804;Potirendaba;2013;31;1,96;28;1,77;3;0,19
3540804;Potirendaba;2014;31;1,94;28;1,75;3;0,19
3540804;Potirendaba;2015;31;1,93;28;1,74;3;0,19
3540804;Potirendaba;2016;31;1,91;28;1,73;3;0,19
3540804;Potirendaba;2017;31;1,9;28;1,72;3;0,18
3540804;Potirendaba;2018;31;1,89;28;1,71;3;0,18
3540804;Potirendaba;2019;31;1,88;27;1,64;4;0,24
3540853;Pracinha;2010;0;0;0;0;0;0
3540853;Pracinha;2011;0;0;0;0;0;0
3540853;Pracinha;2012;0;0;0;0;0;0
3540853;Pracinha;2013;0;0;0;0;0;0
3540853;Pracinha;2014;0;0;0;0;0;0
3540853;Pracinha;2015;0;0;0;0;0;0
3540853;Pracinha;2016;0;0;0;0;0;0
3540853;Pracinha;2017;0;0;0;0;0;0
3540853;Pracinha;2018;0;0;0;0;0;0
3540853;Pracinha;2019;0;0;0;0;0;0
3540903;Pradópolis;2010;0;0;0;0;0;0
3540903;Pradópolis;2011;0;0;0;0;0;0
3540903;Pradópolis;2012;0;0;0;0;0;0
3540903;Pradópolis;2013;0;0;0;0;0;0
3540903;Pradópolis;2014;0;0;0;0;0;0
3540903;Pradópolis;2015;0;0;0;0;0;0
3540903;Pradópolis;2016;0;0;0;0;0;0
3540903;Pradópolis;2017;0;0;0;0;0;0
3540903;Pradópolis;2018;0;0;0;0;0;0
3540903;Pradópolis;2019;0;0;0;0;0;0
3541000;Praia Grande;2010;208;0,8;156;0,6;52;0,2
3541000;Praia Grande;2011;199;0,75;113;0,42;86;0,32
3541000;Praia Grande;2012;199;0,73;113;0,41;86;0,32
3541000;Praia Grande;2013;199;0,71;113;0,41;86;0,31
3541000;Praia Grande;2014;189;0,66;113;0,4;76;0,27
3541000;Praia Grande;2015;194;0,67;118;0,41;76;0,26
3541000;Praia Grande;2016;192;0,65;179;0,6;13;0,04
3541000;Praia Grande;2017;192;0,64;179;0,59;13;0,04
3541000;Praia Grande;2018;212;0,69;199;0,65;13;0,04
3541000;Praia Grande;2019;212;0,68;199;0,64;13;0,04
3541059;Pratânia;2010;0;0;0;0;0;0
3541059;Pratânia;2011;0;0;0;0;0;0
3541059;Pratânia;2012;0;0;0;0;0;0
3541059;Pratânia;2013;0;0;0;0;0;0
3541059;Pratânia;2014;0;0;0;0;0;0
3541059;Pratânia;2015;0;0;0;0;0;0
3541059;Pratânia;2016;0;0;0;0;0;0
3541059;Pratânia;2017;0;0;0;0;0;0
3541059;Pratânia;2018;0;0;0;0;0;0
3541059;Pratânia;2019;0;0;0;0;0;0
3541109;Presidente Alves;2010;0;0;0;0;0;0
3541109;Presidente Alves;2011;0;0;0;0;0;0
3541109;Presidente Alves;2012;0;0;0;0;0;0
3541109;Presidente Alves;2013;0;0;0;0;0;0
3541109;Presidente Alves;2014;0;0;0;0;0;0
3541109;Presidente Alves;2015;0;0;0;0;0;0
3541109;Presidente Alves;2016;0;0;0;0;0;0
3541109;Presidente Alves;2017;0;0;0;0;0;0
3541109;Presidente Alves;2018;120;29,73;0;0;120;29,73
3541109;Presidente Alves;2019;0;0;0;0;0;0
3541208;Presidente Bernardes;2010;51;3,76;40;2,95;11;0,81
3541208;Presidente Bernardes;2011;51;3,75;40;2,94;11;0,81
3541208;Presidente Bernardes;2012;51;3,75;40;2,94;11;0,81
3541208;Presidente Bernardes;2013;51;3,74;40;2,93;11;0,81
3541208;Presidente Bernardes;2014;51;3,74;40;2,93;11;0,81
3541208;Presidente Bernardes;2015;51;3,73;40;2,93;11;0,8
3541208;Presidente Bernardes;2016;51;3,73;40;2,92;11;0,8
3541208;Presidente Bernardes;2017;51;3,73;40;2,92;11;0,8
3541208;Presidente Bernardes;2018;51;3,72;40;2,92;11;0,8
3541208;Presidente Bernardes;2019;51;3,72;40;2,92;11;0,8
3541307;Presidente Epitácio;2010;78;1,89;68;1,65;10;0,24
3541307;Presidente Epitácio;2011;78;1,88;68;1,64;10;0,24
3541307;Presidente Epitácio;2012;78;1,88;68;1,64;10;0,24
3541307;Presidente Epitácio;2013;78;1,87;68;1,63;10;0,24
3541307;Presidente Epitácio;2014;78;1,87;68;1,63;10;0,24
3541307;Presidente Epitácio;2015;78;1,86;68;1,63;10;0,24
3541307;Presidente Epitácio;2016;78;1,86;68;1,62;10;0,24
3541307;Presidente Epitácio;2017;78;1,85;68;1,62;10;0,24
3541307;Presidente Epitácio;2018;78;1,85;68;1,61;10;0,24
3541307;Presidente Epitácio;2019;78;1,84;68;1,61;10;0,24
3541406;Presidente Prudente;2010;1588;7,65;1079;5,2;509;2,45
3541406;Presidente Prudente;2011;1578;7,55;1094;5,24;484;2,32
3541406;Presidente Prudente;2012;1608;7,64;1094;5,2;514;2,44
3541406;Presidente Prudente;2013;1570;7,41;1094;5,16;476;2,25
3541406;Presidente Prudente;2014;1538;7,21;1088;5,1;450;2,11
3541406;Presidente Prudente;2015;1559;7,26;1088;5,07;471;2,19
3541406;Presidente Prudente;2016;1138;5,27;760;3,52;378;1,75
3541406;Presidente Prudente;2017;1041;4,79;680;3,13;361;1,66
3541406;Presidente Prudente;2018;1028;4,7;676;3,09;352;1,61
3541406;Presidente Prudente;2019;1165;5,3;689;3,13;476;2,17
3541505;Presidente Venceslau;2010;97;2,56;75;1,98;22;0,58
3541505;Presidente Venceslau;2011;97;2,56;75;1,98;22;0,58
3541505;Presidente Venceslau;2012;97;2,56;75;1,98;22;0,58
3541505;Presidente Venceslau;2013;97;2,56;75;1,98;22;0,58
3541505;Presidente Venceslau;2014;97;2,55;75;1,97;22;0,58
3541505;Presidente Venceslau;2015;97;2,55;75;1,97;22;0,58
3541505;Presidente Venceslau;2016;99;2,61;57;1,5;42;1,11
3541505;Presidente Venceslau;2017;96;2,53;60;1,58;36;0,95
3541505;Presidente Venceslau;2018;96;2,53;60;1,58;36;0,95
3541505;Presidente Venceslau;2019;96;2,53;60;1,58;36;0,95
3541604;Promissão;2010;78;2,19;78;2,19;0;0
3541604;Promissão;2011;78;2,16;78;2,16;0;0
3541604;Promissão;2012;78;2,14;78;2,14;0;0
3541604;Promissão;2013;75;2,03;75;2,03;0;0
3541604;Promissão;2014;75;2,01;75;2,01;0;0
3541604;Promissão;2015;58;1,54;58;1,54;0;0
3541604;Promissão;2016;58;1,52;58;1,52;0;0
3541604;Promissão;2017;58;1,51;58;1,51;0;0
3541604;Promissão;2018;45;1,16;45;1,16;0;0
3541604;Promissão;2019;37;0,94;37;0,94;0;0
3541653;Quadra;2010;0;0;0;0;0;0
3541653;Quadra;2011;0;0;0;0;0;0
3541653;Quadra;2012;0;0;0;0;0;0
3541653;Quadra;2013;0;0;0;0;0;0
3541653;Quadra;2014;0;0;0;0;0;0
3541653;Quadra;2015;0;0;0;0;0;0
3541653;Quadra;2016;0;0;0;0;0;0
3541653;Quadra;2017;0;0;0;0;0;0
3541653;Quadra;2018;0;0;0;0;0;0
3541653;Quadra;2019;0;0;0;0;0;0
3541703;Quatá;2010;0;0;0;0;0;0
3541703;Quatá;2011;0;0;0;0;0;0
3541703;Quatá;2012;0;0;0;0;0;0
3541703;Quatá;2013;0;0;0;0;0;0
3541703;Quatá;2014;0;0;0;0;0;0
3541703;Quatá;2015;0;0;0;0;0;0
3541703;Quatá;2016;0;0;0;0;0;0
3541703;Quatá;2017;0;0;0;0;0;0
3541703;Quatá;2018;0;0;0;0;0;0
3541703;Quatá;2019;0;0;0;0;0;0
3541802;Queiroz;2010;0;0;0;0;0;0
3541802;Queiroz;2011;0;0;0;0;0;0
3541802;Queiroz;2012;0;0;0;0;0;0
3541802;Queiroz;2013;0;0;0;0;0;0
3541802;Queiroz;2014;0;0;0;0;0;0
3541802;Queiroz;2015;0;0;0;0;0;0
3541802;Queiroz;2016;0;0;0;0;0;0
3541802;Queiroz;2017;0;0;0;0;0;0
3541802;Queiroz;2018;0;0;0;0;0;0
3541802;Queiroz;2019;0;0;0;0;0;0
3541901;Queluz;2010;38;3,37;28;2,48;10;0,89
3541901;Queluz;2011;26;2,27;26;2,27;0;0
3541901;Queluz;2012;26;2,24;26;2,24;0;0
3541901;Queluz;2013;26;2,21;26;2,21;0;0
3541901;Queluz;2014;26;2,19;26;2,19;0;0
3541901;Queluz;2015;19;1,58;19;1,58;0;0
3541901;Queluz;2016;20;1,64;20;1,64;0;0
3541901;Queluz;2017;38;3,09;38;3,09;0;0
3541901;Queluz;2018;38;3,06;38;3,06;0;0
3541901;Queluz;2019;38;3,03;38;3,03;0;0
3542008;Quintana;2010;0;0;0;0;0;0
3542008;Quintana;2011;0;0;0;0;0;0
3542008;Quintana;2012;0;0;0;0;0;0
3542008;Quintana;2013;0;0;0;0;0;0
3542008;Quintana;2014;0;0;0;0;0;0
3542008;Quintana;2015;0;0;0;0;0;0
3542008;Quintana;2016;0;0;0;0;0;0
3542008;Quintana;2017;0;0;0;0;0;0
3542008;Quintana;2018;0;0;0;0;0;0
3542008;Quintana;2019;0;0;0;0;0;0
3542107;Rafard;2010;0;0;0;0;0;0
3542107;Rafard;2011;0;0;0;0;0;0
3542107;Rafard;2012;0;0;0;0;0;0
3542107;Rafard;2013;0;0;0;0;0;0
3542107;Rafard;2014;0;0;0;0;0;0
3542107;Rafard;2015;0;0;0;0;0;0
3542107;Rafard;2016;0;0;0;0;0;0
3542107;Rafard;2017;0;0;0;0;0;0
3542107;Rafard;2018;0;0;0;0;0;0
3542107;Rafard;2019;0;0;0;0;0;0
3542206;Rancharia;2010;98;3,4;70;2,43;28;0,97
3542206;Rancharia;2011;98;3,4;70;2,43;28;0,97
3542206;Rancharia;2012;98;3,4;70;2,43;28;0,97
3542206;Rancharia;2013;98;3,4;70;2,43;28;0,97
3542206;Rancharia;2014;98;3,4;70;2,43;28;0,97
3542206;Rancharia;2015;98;3,4;70;2,43;28;0,97
3542206;Rancharia;2016;98;3,4;70;2,43;28;0,97
3542206;Rancharia;2017;103;3,57;71;2,46;32;1,11
3542206;Rancharia;2018;103;3,57;71;2,46;32;1,11
3542206;Rancharia;2019;103;3,57;71;2,46;32;1,11
3542305;Redenção da Serra;2010;0;0;0;0;0;0
3542305;Redenção da Serra;2011;0;0;0;0;0;0
3542305;Redenção da Serra;2012;0;0;0;0;0;0
3542305;Redenção da Serra;2013;0;0;0;0;0;0
3542305;Redenção da Serra;2014;0;0;0;0;0;0
3542305;Redenção da Serra;2015;0;0;0;0;0;0
3542305;Redenção da Serra;2016;0;0;0;0;0;0
3542305;Redenção da Serra;2017;0;0;0;0;0;0
3542305;Redenção da Serra;2018;0;0;0;0;0;0
3542305;Redenção da Serra;2019;0;0;0;0;0;0
3542404;Regente Feijó;2010;24;1,3;17;0,92;7;0,38
3542404;Regente Feijó;2011;24;1,29;17;0,91;7;0,38
3542404;Regente Feijó;2012;24;1,28;17;0,91;7;0,37
3542404;Regente Feijó;2013;24;1,28;17;0,9;7;0,37
3542404;Regente Feijó;2014;24;1,27;17;0,9;7;0,37
3542404;Regente Feijó;2015;24;1,26;17;0,89;7;0,37
3542404;Regente Feijó;2016;24;1,26;17;0,89;7;0,37
3542404;Regente Feijó;2017;16;0,83;13;0,68;3;0,16
3542404;Regente Feijó;2018;16;0,83;13;0,67;3;0,16
3542404;Regente Feijó;2019;16;0,82;13;0,67;3;0,15
3542503;Reginópolis;2010;0;0;0;0;0;0
3542503;Reginópolis;2011;0;0;0;0;0;0
3542503;Reginópolis;2012;0;0;0;0;0;0
3542503;Reginópolis;2013;0;0;0;0;0;0
3542503;Reginópolis;2014;0;0;0;0;0;0
3542503;Reginópolis;2015;0;0;0;0;0;0
3542503;Reginópolis;2016;0;0;0;0;0;0
3542503;Reginópolis;2017;0;0;0;0;0;0
3542503;Reginópolis;2018;0;0;0;0;0;0
3542503;Reginópolis;2019;0;0;0;0;0;0
3542602;Registro;2010;90;1,66;48;0,88;42;0,77
3542602;Registro;2011;90;1,66;48;0,89;42;0,77
3542602;Registro;2012;105;1,94;63;1,16;42;0,78
3542602;Registro;2013;105;1,94;63;1,16;42;0,78
3542602;Registro;2014;105;1,94;63;1,17;42;0,78
3542602;Registro;2015;110;2,04;68;1,26;42;0,78
3542602;Registro;2016;115;2,13;63;1,17;52;0,96
3542602;Registro;2017;110;2,03;68;1,26;42;0,78
3542602;Registro;2018;145;2,68;98;1,81;47;0,87
3542602;Registro;2019;181;3,34;128;2,36;53;0,98
3542701;Restinga;2010;0;0;0;0;0;0
3542701;Restinga;2011;0;0;0;0;0;0
3542701;Restinga;2012;0;0;0;0;0;0
3542701;Restinga;2013;0;0;0;0;0;0
3542701;Restinga;2014;0;0;0;0;0;0
3542701;Restinga;2015;0;0;0;0;0;0
3542701;Restinga;2016;0;0;0;0;0;0
3542701;Restinga;2017;0;0;0;0;0;0
3542701;Restinga;2018;0;0;0;0;0;0
3542701;Restinga;2019;0;0;0;0;0;0
3542800;Ribeira;2010;0;0;0;0;0;0
3542800;Ribeira;2011;0;0;0;0;0;0
3542800;Ribeira;2012;0;0;0;0;0;0
3542800;Ribeira;2013;0;0;0;0;0;0
3542800;Ribeira;2014;0;0;0;0;0;0
3542800;Ribeira;2015;0;0;0;0;0;0
3542800;Ribeira;2016;0;0;0;0;0;0
3542800;Ribeira;2017;0;0;0;0;0;0
3542800;Ribeira;2018;0;0;0;0;0;0
3542800;Ribeira;2019;0;0;0;0;0;0
3542909;Ribeirão Bonito;2010;21;1,73;9;0,74;12;0,99
3542909;Ribeirão Bonito;2011;21;1,72;9;0,74;12;0,98
3542909;Ribeirão Bonito;2012;17;1,38;9;0,73;8;0,65
3542909;Ribeirão Bonito;2013;17;1,37;11;0,89;6;0,48
3542909;Ribeirão Bonito;2014;17;1,36;11;0,88;6;0,48
3542909;Ribeirão Bonito;2015;17;1,36;11;0,88;6;0,48
3542909;Ribeirão Bonito;2016;17;1,35;11;0,87;6;0,48
3542909;Ribeirão Bonito;2017;17;1,34;11;0,87;6;0,47
3542909;Ribeirão Bonito;2018;17;1,33;11;0,86;6;0,47
3542909;Ribeirão Bonito;2019;17;1,32;11;0,85;6;0,47
3543006;Ribeirão Branco;2010;39;2,13;38;2,08;1;0,05
3543006;Ribeirão Branco;2011;39;2,14;38;2,09;1;0,05
3543006;Ribeirão Branco;2012;36;1,99;35;1,94;1;0,06
3543006;Ribeirão Branco;2013;36;2;35;1,95;1;0,06
3543006;Ribeirão Branco;2014;36;2,02;35;1,96;1;0,06
3543006;Ribeirão Branco;2015;36;2,03;35;1,97;1;0,06
3543006;Ribeirão Branco;2016;36;2,03;35;1,97;1;0,06
3543006;Ribeirão Branco;2017;36;2,03;35;1,97;1;0,06
3543006;Ribeirão Branco;2018;36;2,03;35;1,98;1;0,06
3543006;Ribeirão Branco;2019;36;2,03;35;1,98;1;0,06
3543105;Ribeirão Corrente;2010;0;0;0;0;0;0
3543105;Ribeirão Corrente;2011;0;0;0;0;0;0
3543105;Ribeirão Corrente;2012;0;0;0;0;0;0
3543105;Ribeirão Corrente;2013;0;0;0;0;0;0
3543105;Ribeirão Corrente;2014;0;0;0;0;0;0
3543105;Ribeirão Corrente;2015;0;0;0;0;0;0
3543105;Ribeirão Corrente;2016;0;0;0;0;0;0
3543105;Ribeirão Corrente;2017;0;0;0;0;0;0
3543105;Ribeirão Corrente;2018;0;0;0;0;0;0
3543105;Ribeirão Corrente;2019;0;0;0;0;0;0
3543204;Ribeirão do Sul;2010;0;0;0;0;0;0
3543204;Ribeirão do Sul;2011;0;0;0;0;0;0
3543204;Ribeirão do Sul;2012;0;0;0;0;0;0
3543204;Ribeirão do Sul;2013;0;0;0;0;0;0
3543204;Ribeirão do Sul;2014;0;0;0;0;0;0
3543204;Ribeirão do Sul;2015;0;0;0;0;0;0
3543204;Ribeirão do Sul;2016;0;0;0;0;0;0
3543204;Ribeirão do Sul;2017;0;0;0;0;0;0
3543204;Ribeirão do Sul;2018;0;0;0;0;0;0
3543204;Ribeirão do Sul;2019;0;0;0;0;0;0
3543238;Ribeirão dos Índios;2010;0;0;0;0;0;0
3543238;Ribeirão dos Índios;2011;0;0;0;0;0;0
3543238;Ribeirão dos Índios;2012;0;0;0;0;0;0
3543238;Ribeirão dos Índios;2013;0;0;0;0;0;0
3543238;Ribeirão dos Índios;2014;0;0;0;0;0;0
3543238;Ribeirão dos Índios;2015;0;0;0;0;0;0
3543238;Ribeirão dos Índios;2016;0;0;0;0;0;0
3543238;Ribeirão dos Índios;2017;0;0;0;0;0;0
3543238;Ribeirão dos Índios;2018;0;0;0;0;0;0
3543238;Ribeirão dos Índios;2019;0;0;0;0;0;0
3543253;Ribeirão Grande;2010;0;0;0;0;0;0
3543253;Ribeirão Grande;2011;0;0;0;0;0;0
3543253;Ribeirão Grande;2012;0;0;0;0;0;0
3543253;Ribeirão Grande;2013;0;0;0;0;0;0
3543253;Ribeirão Grande;2014;0;0;0;0;0;0
3543253;Ribeirão Grande;2015;0;0;0;0;0;0
3543253;Ribeirão Grande;2016;0;0;0;0;0;0
3543253;Ribeirão Grande;2017;0;0;0;0;0;0
3543253;Ribeirão Grande;2018;0;0;0;0;0;0
3543253;Ribeirão Grande;2019;0;0;0;0;0;0
3543303;Ribeirão Pires;2010;128;1,13;45;0,4;83;0,73
3543303;Ribeirão Pires;2011;164;1,44;50;0,44;114;1
3543303;Ribeirão Pires;2012;164;1,43;50;0,44;114;1
3543303;Ribeirão Pires;2013;164;1,43;50;0,43;114;0,99
3543303;Ribeirão Pires;2014;164;1,42;50;0,43;114;0,99
3543303;Ribeirão Pires;2015;164;1,41;50;0,43;114;0,98
3543303;Ribeirão Pires;2016;164;1,4;50;0,43;114;0,98
3543303;Ribeirão Pires;2017;164;1,4;50;0,43;114;0,97
3543303;Ribeirão Pires;2018;164;1,39;50;0,42;114;0,97
3543303;Ribeirão Pires;2019;164;1,38;50;0,42;114;0,96
3543402;Ribeirão Preto;2010;1896;3,14;1347;2,23;549;0,91
3543402;Ribeirão Preto;2011;1920;3,14;1365;2,23;555;0,91
3543402;Ribeirão Preto;2012;1918;3,09;1374;2,21;544;0,88
3543402;Ribeirão Preto;2013;1980;3,14;1369;2,17;611;0,97
3543402;Ribeirão Preto;2014;2051;3,21;1387;2,17;664;1,04
3543402;Ribeirão Preto;2015;2044;3,15;1399;2,16;645;1
3543402;Ribeirão Preto;2016;2160;3,3;1405;2,15;755;1,15
3543402;Ribeirão Preto;2017;2157;3,26;1399;2,11;758;1,15
3543402;Ribeirão Preto;2018;2188;3,27;1415;2,11;773;1,16
3543402;Ribeirão Preto;2019;2183;3,23;1388;2,05;795;1,18
3543600;Rifaina;2010;0;0;0;0;0;0
3543600;Rifaina;2011;0;0;0;0;0;0
3543600;Rifaina;2012;0;0;0;0;0;0
3543600;Rifaina;2013;0;0;0;0;0;0
3543600;Rifaina;2014;0;0;0;0;0;0
3543600;Rifaina;2015;0;0;0;0;0;0
3543600;Rifaina;2016;0;0;0;0;0;0
3543600;Rifaina;2017;0;0;0;0;0;0
3543600;Rifaina;2018;0;0;0;0;0;0
3543600;Rifaina;2019;0;0;0;0;0;0
3543709;Rincão;2010;0;0;0;0;0;0
3543709;Rincão;2011;0;0;0;0;0;0
3543709;Rincão;2012;0;0;0;0;0;0
3543709;Rincão;2013;0;0;0;0;0;0
3543709;Rincão;2014;0;0;0;0;0;0
3543709;Rincão;2015;0;0;0;0;0;0
3543709;Rincão;2016;0;0;0;0;0;0
3543709;Rincão;2017;0;0;0;0;0;0
3543709;Rincão;2018;0;0;0;0;0;0
3543709;Rincão;2019;0;0;0;0;0;0
3543808;Rinópolis;2010;33;3,32;20;2,01;13;1,31
3543808;Rinópolis;2011;33;3,33;20;2,02;13;1,31
3543808;Rinópolis;2012;33;3,34;20;2,02;13;1,31
3543808;Rinópolis;2013;33;3,35;25;2,53;8;0,81
3543808;Rinópolis;2014;33;3,35;25;2,54;8;0,81
3543808;Rinópolis;2015;33;3,36;25;2,55;8;0,82
3543808;Rinópolis;2016;23;2,35;20;2,04;3;0,31
3543808;Rinópolis;2017;23;2,35;20;2,05;3;0,31
3543808;Rinópolis;2018;23;2,36;20;2,05;3;0,31
3543808;Rinópolis;2019;23;2,36;20;2,05;3;0,31
3543907;Rio Claro;2010;456;2,45;276;1,48;180;0,97
3543907;Rio Claro;2011;488;2,6;270;1,44;218;1,16
3543907;Rio Claro;2012;510;2,69;274;1,45;236;1,25
3543907;Rio Claro;2013;478;2,5;274;1,44;204;1,07
3543907;Rio Claro;2014;482;2,5;278;1,44;204;1,06
3543907;Rio Claro;2015;482;2,48;278;1,43;204;1,05
3543907;Rio Claro;2016;477;2,44;267;1,37;210;1,07
3543907;Rio Claro;2017;427;2,17;238;1,21;189;0,96
3543907;Rio Claro;2018;392;1,98;190;0,96;202;1,02
3543907;Rio Claro;2019;391;1,96;188;0,94;203;1,02
3544004;Rio das Pedras;2010;60;2,04;41;1,39;19;0,65
3544004;Rio das Pedras;2011;60;2;41;1,37;19;0,63
3544004;Rio das Pedras;2012;53;1,74;38;1,25;15;0,49
3544004;Rio das Pedras;2013;53;1,71;38;1,22;15;0,48
3544004;Rio das Pedras;2014;53;1,68;38;1,2;15;0,47
3544004;Rio das Pedras;2015;53;1,65;38;1,18;15;0,47
3544004;Rio das Pedras;2016;47;1,44;28;0,86;19;0,58
3544004;Rio das Pedras;2017;42;1,27;28;0,85;14;0,42
3544004;Rio das Pedras;2018;44;1,31;32;0,96;12;0,36
3544004;Rio das Pedras;2019;36;1,06;32;0,94;4;0,12
3544103;Rio Grande da Serra;2010;0;0;0;0;0;0
3544103;Rio Grande da Serra;2011;0;0;0;0;0;0
3544103;Rio Grande da Serra;2012;0;0;0;0;0;0
3544103;Rio Grande da Serra;2013;0;0;0;0;0;0
3544103;Rio Grande da Serra;2014;0;0;0;0;0;0
3544103;Rio Grande da Serra;2015;0;0;0;0;0;0
3544103;Rio Grande da Serra;2016;0;0;0;0;0;0
3544103;Rio Grande da Serra;2017;0;0;0;0;0;0
3544103;Rio Grande da Serra;2018;0;0;0;0;0;0
3544103;Rio Grande da Serra;2019;0;0;0;0;0;0
3544202;Riolândia;2010;36;3,41;7;0,66;29;2,75
3544202;Riolândia;2011;36;3,38;7;0,66;29;2,72
3544202;Riolândia;2012;36;3,35;7;0,65;29;2,7
3544202;Riolândia;2013;36;3,33;7;0,65;29;2,68
3544202;Riolândia;2014;36;3,3;7;0,64;29;2,66
3544202;Riolândia;2015;36;3,27;7;0,64;29;2,64
3544202;Riolândia;2016;36;3,25;7;0,63;29;2,62
3544202;Riolândia;2017;36;3,22;7;0,63;29;2,6
3544202;Riolândia;2018;36;3,2;7;0,62;29;2,58
3544202;Riolândia;2019;36;3,17;7;0,62;29;2,56
3543501;Riversul;2010;0;0;0;0;0;0
3543501;Riversul;2011;0;0;0;0;0;0
3543501;Riversul;2012;0;0;0;0;0;0
3543501;Riversul;2013;0;0;0;0;0;0
3543501;Riversul;2014;0;0;0;0;0;0
3543501;Riversul;2015;0;0;0;0;0;0
3543501;Riversul;2016;0;0;0;0;0;0
3543501;Riversul;2017;0;0;0;0;0;0
3543501;Riversul;2018;0;0;0;0;0;0
3543501;Riversul;2019;0;0;0;0;0;0
3544251;Rosana;2010;66;3,35;58;2,94;8;0,41
3544251;Rosana;2011;66;3,37;58;2,97;8;0,41
3544251;Rosana;2012;57;2,94;57;2,94;0;0
3544251;Rosana;2013;57;2,97;57;2,97;0;0
3544251;Rosana;2014;57;2,99;57;2,99;0;0
3544251;Rosana;2015;57;3,02;57;3,02;0;0
3544251;Rosana;2016;57;3,03;57;3,03;0;0
3544251;Rosana;2017;57;3,05;57;3,05;0;0
3544251;Rosana;2018;57;3,07;57;3,07;0;0
3544251;Rosana;2019;57;3,08;57;3,08;0;0
3544301;Roseira;2010;14;1,46;14;1,46;0;0
3544301;Roseira;2011;14;1,44;14;1,44;0;0
3544301;Roseira;2012;14;1,43;14;1,43;0;0
3544301;Roseira;2013;14;1,41;14;1,41;0;0
3544301;Roseira;2014;14;1,4;14;1,4;0;0
3544301;Roseira;2015;14;1,38;14;1,38;0;0
3544301;Roseira;2016;14;1,37;14;1,37;0;0
3544301;Roseira;2017;14;1,35;14;1,35;0;0
3544301;Roseira;2018;54;5,17;14;1,34;40;3,83
3544301;Roseira;2019;54;5,12;14;1,33;40;3,8
3544400;Rubiácea;2010;0;0;0;0;0;0
3544400;Rubiácea;2011;0;0;0;0;0;0
3544400;Rubiácea;2012;0;0;0;0;0;0
3544400;Rubiácea;2013;0;0;0;0;0;0
3544400;Rubiácea;2014;0;0;0;0;0;0
3544400;Rubiácea;2015;0;0;0;0;0;0
3544400;Rubiácea;2016;0;0;0;0;0;0
3544400;Rubiácea;2017;0;0;0;0;0;0
3544400;Rubiácea;2018;0;0;0;0;0;0
3544400;Rubiácea;2019;0;0;0;0;0;0
3544509;Rubinéia;2010;0;0;0;0;0;0
3544509;Rubinéia;2011;0;0;0;0;0;0
3544509;Rubinéia;2012;0;0;0;0;0;0
3544509;Rubinéia;2013;0;0;0;0;0;0
3544509;Rubinéia;2014;0;0;0;0;0;0
3544509;Rubinéia;2015;0;0;0;0;0;0
3544509;Rubinéia;2016;0;0;0;0;0;0
3544509;Rubinéia;2017;0;0;0;0;0;0
3544509;Rubinéia;2018;0;0;0;0;0;0
3544509;Rubinéia;2019;0;0;0;0;0;0
3544608;Sabino;2010;0;0;0;0;0;0
3544608;Sabino;2011;0;0;0;0;0;0
3544608;Sabino;2012;0;0;0;0;0;0
3544608;Sabino;2013;0;0;0;0;0;0
3544608;Sabino;2014;0;0;0;0;0;0
3544608;Sabino;2015;0;0;0;0;0;0
3544608;Sabino;2016;0;0;0;0;0;0
3544608;Sabino;2017;0;0;0;0;0;0
3544608;Sabino;2018;0;0;0;0;0;0
3544608;Sabino;2019;0;0;0;0;0;0
3544707;Sagres;2010;0;0;0;0;0;0
3544707;Sagres;2011;0;0;0;0;0;0
3544707;Sagres;2012;0;0;0;0;0;0
3544707;Sagres;2013;0;0;0;0;0;0
3544707;Sagres;2014;0;0;0;0;0;0
3544707;Sagres;2015;0;0;0;0;0;0
3544707;Sagres;2016;0;0;0;0;0;0
3544707;Sagres;2017;0;0;0;0;0;0
3544707;Sagres;2018;0;0;0;0;0;0
3544707;Sagres;2019;0;0;0;0;0;0
3544806;Sales;2010;0;0;0;0;0;0
3544806;Sales;2011;0;0;0;0;0;0
3544806;Sales;2012;0;0;0;0;0;0
3544806;Sales;2013;0;0;0;0;0;0
3544806;Sales;2014;0;0;0;0;0;0
3544806;Sales;2015;0;0;0;0;0;0
3544806;Sales;2016;0;0;0;0;0;0
3544806;Sales;2017;0;0;0;0;0;0
3544806;Sales;2018;0;0;0;0;0;0
3544806;Sales;2019;0;0;0;0;0;0
3544905;Sales Oliveira;2010;29;2,75;19;1,8;10;0,95
3544905;Sales Oliveira;2011;29;2,72;19;1,78;10;0,94
3544905;Sales Oliveira;2012;29;2,69;19;1,76;10;0,93
3544905;Sales Oliveira;2013;29;2,67;19;1,75;10;0,92
3544905;Sales Oliveira;2014;29;2,64;19;1,73;10;0,91
3544905;Sales Oliveira;2015;29;2,62;19;1,71;10;0,9
3544905;Sales Oliveira;2016;29;2,6;19;1,7;10;0,9
3544905;Sales Oliveira;2017;29;2,58;19;1,69;10;0,89
3544905;Sales Oliveira;2018;29;2,56;19;1,68;10;0,88
3544905;Sales Oliveira;2019;30;2,62;20;1,75;10;0,87
3545001;Salesópolis;2010;24;1,54;21;1,34;3;0,19
3545001;Salesópolis;2011;24;1,52;21;1,33;3;0,19
3545001;Salesópolis;2012;24;1,51;21;1,32;3;0,19
3545001;Salesópolis;2013;24;1,5;21;1,31;3;0,19
3545001;Salesópolis;2014;24;1,49;21;1,3;3;0,19
3545001;Salesópolis;2015;19;1,17;17;1,05;2;0,12
3545001;Salesópolis;2016;19;1,16;17;1,04;2;0,12
3545001;Salesópolis;2017;19;1,15;17;1,03;2;0,12
3545001;Salesópolis;2018;19;1,15;17;1,02;2;0,12
3545001;Salesópolis;2019;19;1,14;17;1,02;2;0,12
3545100;Salmourão;2010;0;0;0;0;0;0
3545100;Salmourão;2011;0;0;0;0;0;0
3545100;Salmourão;2012;0;0;0;0;0;0
3545100;Salmourão;2013;0;0;0;0;0;0
3545100;Salmourão;2014;0;0;0;0;0;0
3545100;Salmourão;2015;0;0;0;0;0;0
3545100;Salmourão;2016;0;0;0;0;0;0
3545100;Salmourão;2017;0;0;0;0;0;0
3545100;Salmourão;2018;0;0;0;0;0;0
3545100;Salmourão;2019;0;0;0;0;0;0
3545159;Saltinho;2010;0;0;0;0;0;0
3545159;Saltinho;2011;0;0;0;0;0;0
3545159;Saltinho;2012;0;0;0;0;0;0
3545159;Saltinho;2013;0;0;0;0;0;0
3545159;Saltinho;2014;0;0;0;0;0;0
3545159;Saltinho;2015;0;0;0;0;0;0
3545159;Saltinho;2016;0;0;0;0;0;0
3545159;Saltinho;2017;0;0;0;0;0;0
3545159;Saltinho;2018;0;0;0;0;0;0
3545159;Saltinho;2019;0;0;0;0;0;0
3545209;Salto;2010;99;0,94;55;0,52;44;0,42
3545209;Salto;2011;123;1,16;69;0,65;54;0,51
3545209;Salto;2012;123;1,14;70;0,65;53;0,49
3545209;Salto;2013;123;1,13;70;0,65;53;0,49
3545209;Salto;2014;123;1,12;70;0,64;53;0,48
3545209;Salto;2015;123;1,11;70;0,63;53;0,48
3545209;Salto;2016;125;1,12;72;0,65;53;0,48
3545209;Salto;2017;125;1,11;72;0,64;53;0,47
3545209;Salto;2018;116;1,02;62;0,55;54;0,48
3545209;Salto;2019;130;1,14;82;0,72;48;0,42
3545308;Salto de Pirapora;2010;1011;25,22;985;24,57;26;0,65
3545308;Salto de Pirapora;2011;1011;24,95;985;24,31;26;0,64
3545308;Salto de Pirapora;2012;1018;24,86;992;24,23;26;0,63
3545308;Salto de Pirapora;2013;1018;24,6;992;23,97;26;0,63
3545308;Salto de Pirapora;2014;1026;24,53;1000;23,91;26;0,62
3545308;Salto de Pirapora;2015;1026;24,27;1000;23,66;26;0,62
3545308;Salto de Pirapora;2016;921;21,59;723;16,95;198;4,64
3545308;Salto de Pirapora;2017;669;15,54;389;9,04;280;6,51
3545308;Salto de Pirapora;2018;269;6,19;247;5,69;22;0,51
3545308;Salto de Pirapora;2019;48;1,1;43;0,98;5;0,11
3545407;Salto Grande;2010;34;3,87;15;1,71;19;2,16
3545407;Salto Grande;2011;34;3,86;15;1,7;19;2,16
3545407;Salto Grande;2012;34;3,84;17;1,92;17;1,92
3545407;Salto Grande;2013;34;3,83;22;2,48;12;1,35
3545407;Salto Grande;2014;34;3,82;22;2,47;12;1,35
3545407;Salto Grande;2015;34;3,81;22;2,46;12;1,34
3545407;Salto Grande;2016;34;3,79;22;2,45;12;1,34
3545407;Salto Grande;2017;34;3,78;22;2,45;12;1,33
3545407;Salto Grande;2018;34;3,77;22;2,44;12;1,33
3545407;Salto Grande;2019;34;3,75;22;2,43;12;1,32
3545506;Sandovalina;2010;0;0;0;0;0;0
3545506;Sandovalina;2011;0;0;0;0;0;0
3545506;Sandovalina;2012;0;0;0;0;0;0
3545506;Sandovalina;2013;0;0;0;0;0;0
3545506;Sandovalina;2014;0;0;0;0;0;0
3545506;Sandovalina;2015;0;0;0;0;0;0
3545506;Sandovalina;2016;0;0;0;0;0;0
3545506;Sandovalina;2017;0;0;0;0;0;0
3545506;Sandovalina;2018;0;0;0;0;0;0
3545506;Sandovalina;2019;0;0;0;0;0;0
3545605;Santa Adélia;2010;31;2,16;11;0,77;20;1,4
3545605;Santa Adélia;2011;31;2,15;11;0,76;20;1,39
3545605;Santa Adélia;2012;31;2,15;11;0,76;20;1,38
3545605;Santa Adélia;2013;31;2,14;11;0,76;20;1,38
3545605;Santa Adélia;2014;31;2,13;11;0,75;20;1,37
3545605;Santa Adélia;2015;23;1,57;7;0,48;16;1,09
3545605;Santa Adélia;2016;24;1,63;7;0,48;17;1,16
3545605;Santa Adélia;2017;24;1,63;7;0,48;17;1,15
3545605;Santa Adélia;2018;24;1,62;7;0,47;17;1,15
3545605;Santa Adélia;2019;24;1,62;7;0,47;17;1,15
3545704;Santa Albertina;2010;0;0;0;0;0;0
3545704;Santa Albertina;2011;0;0;0;0;0;0
3545704;Santa Albertina;2012;0;0;0;0;0;0
3545704;Santa Albertina;2013;0;0;0;0;0;0
3545704;Santa Albertina;2014;0;0;0;0;0;0
3545704;Santa Albertina;2015;0;0;0;0;0;0
3545704;Santa Albertina;2016;0;0;0;0;0;0
3545704;Santa Albertina;2017;0;0;0;0;0;0
3545704;Santa Albertina;2018;0;0;0;0;0;0
3545704;Santa Albertina;2019;0;0;0;0;0;0
3545803;Santa Bárbara d'Oeste;2010;126;0,7;75;0,42;51;0,28
3545803;Santa Bárbara d'Oeste;2011;126;0,7;75;0,41;51;0,28
3545803;Santa Bárbara d'Oeste;2012;136;0,75;105;0,58;31;0,17
3545803;Santa Bárbara d'Oeste;2013;166;0,91;133;0,73;33;0,18
3545803;Santa Bárbara d'Oeste;2014;159;0,87;100;0,54;59;0,32
3545803;Santa Bárbara d'Oeste;2015;149;0,81;84;0,45;65;0,35
3545803;Santa Bárbara d'Oeste;2016;146;0,79;73;0,39;73;0,39
3545803;Santa Bárbara d'Oeste;2017;156;0,84;85;0,46;71;0,38
3545803;Santa Bárbara d'Oeste;2018;168;0,9;97;0,52;71;0,38
3545803;Santa Bárbara d'Oeste;2019;160;0,85;97;0,52;63;0,34
3546009;Santa Branca;2010;0;0;0;0;0;0
3546009;Santa Branca;2011;0;0;0;0;0;0
3546009;Santa Branca;2012;0;0;0;0;0;0
3546009;Santa Branca;2013;0;0;0;0;0;0
3546009;Santa Branca;2014;0;0;0;0;0;0
3546009;Santa Branca;2015;0;0;0;0;0;0
3546009;Santa Branca;2016;0;0;0;0;0;0
3546009;Santa Branca;2017;0;0;0;0;0;0
3546009;Santa Branca;2018;0;0;0;0;0;0
3546009;Santa Branca;2019;0;0;0;0;0;0
3546108;Santa Clara d'Oeste;2010;0;0;0;0;0;0
3546108;Santa Clara d'Oeste;2011;0;0;0;0;0;0
3546108;Santa Clara d'Oeste;2012;0;0;0;0;0;0
3546108;Santa Clara d'Oeste;2013;0;0;0;0;0;0
3546108;Santa Clara d'Oeste;2014;0;0;0;0;0;0
3546108;Santa Clara d'Oeste;2015;0;0;0;0;0;0
3546108;Santa Clara d'Oeste;2016;0;0;0;0;0;0
3546108;Santa Clara d'Oeste;2017;0;0;0;0;0;0
3546108;Santa Clara d'Oeste;2018;0;0;0;0;0;0
3546108;Santa Clara d'Oeste;2019;0;0;0;0;0;0
3546207;Santa Cruz da Conceição;2010;0;0;0;0;0;0
3546207;Santa Cruz da Conceição;2011;0;0;0;0;0;0
3546207;Santa Cruz da Conceição;2012;0;0;0;0;0;0
3546207;Santa Cruz da Conceição;2013;0;0;0;0;0;0
3546207;Santa Cruz da Conceição;2014;0;0;0;0;0;0
3546207;Santa Cruz da Conceição;2015;0;0;0;0;0;0
3546207;Santa Cruz da Conceição;2016;0;0;0;0;0;0
3546207;Santa Cruz da Conceição;2017;0;0;0;0;0;0
3546207;Santa Cruz da Conceição;2018;0;0;0;0;0;0
3546207;Santa Cruz da Conceição;2019;0;0;0;0;0;0
3546256;Santa Cruz da Esperança;2010;0;0;0;0;0;0
3546256;Santa Cruz da Esperança;2011;0;0;0;0;0;0
3546256;Santa Cruz da Esperança;2012;0;0;0;0;0;0
3546256;Santa Cruz da Esperança;2013;0;0;0;0;0;0
3546256;Santa Cruz da Esperança;2014;0;0;0;0;0;0
3546256;Santa Cruz da Esperança;2015;0;0;0;0;0;0
3546256;Santa Cruz da Esperança;2016;0;0;0;0;0;0
3546256;Santa Cruz da Esperança;2017;0;0;0;0;0;0
3546256;Santa Cruz da Esperança;2018;0;0;0;0;0;0
3546256;Santa Cruz da Esperança;2019;0;0;0;0;0;0
3546306;Santa Cruz das Palmeiras;2010;46;1,54;24;0,8;22;0,74
3546306;Santa Cruz das Palmeiras;2011;44;1,45;23;0,76;21;0,69
3546306;Santa Cruz das Palmeiras;2012;43;1,4;22;0,72;21;0,68
3546306;Santa Cruz das Palmeiras;2013;46;1,48;25;0,8;21;0,68
3546306;Santa Cruz das Palmeiras;2014;46;1,46;25;0,79;21;0,67
3546306;Santa Cruz das Palmeiras;2015;46;1,44;25;0,78;21;0,66
3546306;Santa Cruz das Palmeiras;2016;46;1,43;25;0,77;21;0,65
3546306;Santa Cruz das Palmeiras;2017;46;1,41;25;0,77;21;0,64
3546306;Santa Cruz das Palmeiras;2018;46;1,39;25;0,76;21;0,64
3546306;Santa Cruz das Palmeiras;2019;35;1,05;25;0,75;10;0,3
3546405;Santa Cruz do Rio Pardo;2010;102;2,32;59;1,34;43;0,98
3546405;Santa Cruz do Rio Pardo;2011;102;2,31;59;1,34;43;0,97
3546405;Santa Cruz do Rio Pardo;2012;102;2,3;59;1,33;43;0,97
3546405;Santa Cruz do Rio Pardo;2013;108;2,42;65;1,46;43;0,96
3546405;Santa Cruz do Rio Pardo;2014;100;2,23;65;1,45;35;0,78
3546405;Santa Cruz do Rio Pardo;2015;100;2,22;65;1,44;35;0,78
3546405;Santa Cruz do Rio Pardo;2016;100;2,21;65;1,44;35;0,77
3546405;Santa Cruz do Rio Pardo;2017;100;2,2;65;1,43;35;0,77
3546405;Santa Cruz do Rio Pardo;2018;96;2,1;55;1,2;41;0,9
3546405;Santa Cruz do Rio Pardo;2019;96;2,09;55;1,2;41;0,89
3546504;Santa Ernestina;2010;0;0;0;0;0;0
3546504;Santa Ernestina;2011;0;0;0;0;0;0
3546504;Santa Ernestina;2012;0;0;0;0;0;0
3546504;Santa Ernestina;2013;0;0;0;0;0;0
3546504;Santa Ernestina;2014;0;0;0;0;0;0
3546504;Santa Ernestina;2015;0;0;0;0;0;0
3546504;Santa Ernestina;2016;0;0;0;0;0;0
3546504;Santa Ernestina;2017;0;0;0;0;0;0
3546504;Santa Ernestina;2018;0;0;0;0;0;0
3546504;Santa Ernestina;2019;0;0;0;0;0;0
3546603;Santa Fé do Sul;2010;76;2,6;33;1,13;43;1,47
3546603;Santa Fé do Sul;2011;76;2,59;33;1,12;43;1,46
3546603;Santa Fé do Sul;2012;76;2,57;33;1,12;43;1,46
3546603;Santa Fé do Sul;2013;76;2,56;33;1,11;43;1,45
3546603;Santa Fé do Sul;2014;76;2,54;33;1,1;43;1,44
3546603;Santa Fé do Sul;2015;76;2,53;33;1,1;43;1,43
3546603;Santa Fé do Sul;2016;68;2,25;33;1,09;35;1,16
3546603;Santa Fé do Sul;2017;70;2,31;53;1,75;17;0,56
3546603;Santa Fé do Sul;2018;70;2,29;46;1,51;24;0,79
3546603;Santa Fé do Sul;2019;82;2,68;57;1,86;25;0,82
3546702;Santa Gertrudes;2010;0;0;0;0;0;0
3546702;Santa Gertrudes;2011;0;0;0;0;0;0
3546702;Santa Gertrudes;2012;0;0;0;0;0;0
3546702;Santa Gertrudes;2013;0;0;0;0;0;0
3546702;Santa Gertrudes;2014;0;0;0;0;0;0
3546702;Santa Gertrudes;2015;0;0;0;0;0;0
3546702;Santa Gertrudes;2016;0;0;0;0;0;0
3546702;Santa Gertrudes;2017;0;0;0;0;0;0
3546702;Santa Gertrudes;2018;0;0;0;0;0;0
3546702;Santa Gertrudes;2019;0;0;0;0;0;0
3546801;Santa Isabel;2010;100;1,98;88;1,75;12;0,24
3546801;Santa Isabel;2011;100;1,97;88;1,73;12;0,24
3546801;Santa Isabel;2012;102;1,99;90;1,75;12;0,23
3546801;Santa Isabel;2013;104;2,01;92;1,77;12;0,23
3546801;Santa Isabel;2014;101;1,93;82;1,57;19;0,36
3546801;Santa Isabel;2015;101;1,91;82;1,55;19;0,36
3546801;Santa Isabel;2016;101;1,89;82;1,54;19;0,36
3546801;Santa Isabel;2017;101;1,88;82;1,53;19;0,35
3546801;Santa Isabel;2018;101;1,86;82;1,51;19;0,35
3546801;Santa Isabel;2019;101;1,85;82;1,5;19;0,35
3546900;Santa Lúcia;2010;0;0;0;0;0;0
3546900;Santa Lúcia;2011;0;0;0;0;0;0
3546900;Santa Lúcia;2012;0;0;0;0;0;0
3546900;Santa Lúcia;2013;0;0;0;0;0;0
3546900;Santa Lúcia;2014;0;0;0;0;0;0
3546900;Santa Lúcia;2015;0;0;0;0;0;0
3546900;Santa Lúcia;2016;0;0;0;0;0;0
3546900;Santa Lúcia;2017;0;0;0;0;0;0
3546900;Santa Lúcia;2018;0;0;0;0;0;0
3546900;Santa Lúcia;2019;0;0;0;0;0;0
3547007;Santa Maria da Serra;2010;5;0,92;5;0,92;0;0
3547007;Santa Maria da Serra;2011;5;0,91;5;0,91;0;0
3547007;Santa Maria da Serra;2012;5;0,9;5;0,9;0;0
3547007;Santa Maria da Serra;2013;2;0,36;2;0,36;0;0
3547007;Santa Maria da Serra;2014;8;1,4;8;1,4;0;0
3547007;Santa Maria da Serra;2015;6;1,04;6;1,04;0;0
3547007;Santa Maria da Serra;2016;6;1,03;6;1,03;0;0
3547007;Santa Maria da Serra;2017;6;1,01;6;1,01;0;0
3547007;Santa Maria da Serra;2018;6;1;6;1;0;0
3547007;Santa Maria da Serra;2019;6;0,99;6;0,99;0;0
3547106;Santa Mercedes;2010;0;0;0;0;0;0
3547106;Santa Mercedes;2011;0;0;0;0;0;0
3547106;Santa Mercedes;2012;0;0;0;0;0;0
3547106;Santa Mercedes;2013;0;0;0;0;0;0
3547106;Santa Mercedes;2014;0;0;0;0;0;0
3547106;Santa Mercedes;2015;0;0;0;0;0;0
3547106;Santa Mercedes;2016;0;0;0;0;0;0
3547106;Santa Mercedes;2017;0;0;0;0;0;0
3547106;Santa Mercedes;2018;0;0;0;0;0;0
3547106;Santa Mercedes;2019;0;0;0;0;0;0
3547403;Santa Rita d'Oeste;2010;0;0;0;0;0;0
3547403;Santa Rita d'Oeste;2011;0;0;0;0;0;0
3547403;Santa Rita d'Oeste;2012;0;0;0;0;0;0
3547403;Santa Rita d'Oeste;2013;0;0;0;0;0;0
3547403;Santa Rita d'Oeste;2014;0;0;0;0;0;0
3547403;Santa Rita d'Oeste;2015;0;0;0;0;0;0
3547403;Santa Rita d'Oeste;2016;0;0;0;0;0;0
3547403;Santa Rita d'Oeste;2017;0;0;0;0;0;0
3547403;Santa Rita d'Oeste;2018;0;0;0;0;0;0
3547403;Santa Rita d'Oeste;2019;0;0;0;0;0;0
3547502;Santa Rita do Passa Quatro;2010;299;11,29;276;10,42;23;0,87
3547502;Santa Rita do Passa Quatro;2011;299;11,3;276;10,43;23;0,87
3547502;Santa Rita do Passa Quatro;2012;299;11,3;271;10,24;28;1,06
3547502;Santa Rita do Passa Quatro;2013;299;11,3;271;10,24;28;1,06
3547502;Santa Rita do Passa Quatro;2014;299;11,31;276;10,44;23;0,87
3547502;Santa Rita do Passa Quatro;2015;299;11,31;276;10,44;23;0,87
3547502;Santa Rita do Passa Quatro;2016;299;11,31;276;10,44;23;0,87
3547502;Santa Rita do Passa Quatro;2017;319;12,07;296;11,2;23;0,87
3547502;Santa Rita do Passa Quatro;2018;319;12,08;296;11,21;23;0,87
3547502;Santa Rita do Passa Quatro;2019;316;11,97;293;11,1;23;0,87
3547601;Santa Rosa de Viterbo;2010;30;1,26;18;0,76;12;0,5
3547601;Santa Rosa de Viterbo;2011;30;1,25;18;0,75;12;0,5
3547601;Santa Rosa de Viterbo;2012;30;1,24;18;0,74;12;0,5
3547601;Santa Rosa de Viterbo;2013;30;1,23;18;0,74;12;0,49
3547601;Santa Rosa de Viterbo;2014;30;1,22;18;0,73;12;0,49
3547601;Santa Rosa de Viterbo;2015;30;1,21;18;0,73;12;0,48
3547601;Santa Rosa de Viterbo;2016;30;1,2;18;0,72;12;0,48
3547601;Santa Rosa de Viterbo;2017;30;1,2;18;0,72;12;0,48
3547601;Santa Rosa de Viterbo;2018;30;1,19;18;0,71;12;0,47
3547601;Santa Rosa de Viterbo;2019;32;1,26;21;0,83;11;0,43
3547650;Santa Salete;2010;0;0;0;0;0;0
3547650;Santa Salete;2011;0;0;0;0;0;0
3547650;Santa Salete;2012;0;0;0;0;0;0
3547650;Santa Salete;2013;0;0;0;0;0;0
3547650;Santa Salete;2014;0;0;0;0;0;0
3547650;Santa Salete;2015;0;0;0;0;0;0
3547650;Santa Salete;2016;0;0;0;0;0;0
3547650;Santa Salete;2017;0;0;0;0;0;0
3547650;Santa Salete;2018;0;0;0;0;0;0
3547650;Santa Salete;2019;0;0;0;0;0;0
3547205;Santana da Ponte Pensa;2010;0;0;0;0;0;0
3547205;Santana da Ponte Pensa;2011;0;0;0;0;0;0
3547205;Santana da Ponte Pensa;2012;0;0;0;0;0;0
3547205;Santana da Ponte Pensa;2013;0;0;0;0;0;0
3547205;Santana da Ponte Pensa;2014;0;0;0;0;0;0
3547205;Santana da Ponte Pensa;2015;0;0;0;0;0;0
3547205;Santana da Ponte Pensa;2016;0;0;0;0;0;0
3547205;Santana da Ponte Pensa;2017;0;0;0;0;0;0
3547205;Santana da Ponte Pensa;2018;0;0;0;0;0;0
3547205;Santana da Ponte Pensa;2019;0;0;0;0;0;0
3547304;Santana de Parnaíba;2010;28;0,26;28;0,26;0;0
3547304;Santana de Parnaíba;2011;28;0,25;28;0,25;0;0
3547304;Santana de Parnaíba;2012;20;0,17;20;0,17;0;0
3547304;Santana de Parnaíba;2013;16;0,14;16;0,14;0;0
3547304;Santana de Parnaíba;2014;16;0,13;16;0,13;0;0
3547304;Santana de Parnaíba;2015;35;0,28;35;0,28;0;0
3547304;Santana de Parnaíba;2016;35;0,28;35;0,28;0;0
3547304;Santana de Parnaíba;2017;35;0,27;35;0,27;0;0
3547304;Santana de Parnaíba;2018;35;0,26;35;0,26;0;0
3547304;Santana de Parnaíba;2019;30;0,22;30;0,22;0;0
3547700;Santo Anastácio;2010;56;2,73;37;1,81;19;0,93
3547700;Santo Anastácio;2011;56;2,74;37;1,81;19;0,93
3547700;Santo Anastácio;2012;56;2,75;37;1,81;19;0,93
3547700;Santo Anastácio;2013;56;2,75;37;1,82;19;0,93
3547700;Santo Anastácio;2014;56;2,76;37;1,82;19;0,94
3547700;Santo Anastácio;2015;56;2,76;37;1,83;19;0,94
3547700;Santo Anastácio;2016;56;2,77;37;1,83;19;0,94
3547700;Santo Anastácio;2017;56;2,77;37;1,83;19;0,94
3547700;Santo Anastácio;2018;56;2,78;37;1,83;19;0,94
3547700;Santo Anastácio;2019;56;2,78;37;1,84;19;0,94
3547809;Santo André;2010;1491;2,21;637;0,94;854;1,26
3547809;Santo André;2011;1450;2,14;604;0,89;846;1,25
3547809;Santo André;2012;1501;2,21;669;0,98;832;1,22
3547809;Santo André;2013;1476;2,16;684;1;792;1,16
3547809;Santo André;2014;1548;2,26;698;1,02;850;1,24
3547809;Santo André;2015;1245;1,82;706;1,03;539;0,79
3547809;Santo André;2016;1335;1,94;684;1;651;0,95
3547809;Santo André;2017;1317;1,91;669;0,97;648;0,94
3547809;Santo André;2018;1455;2,11;643;0,93;812;1,18
3547809;Santo André;2019;1540;2,22;708;1,02;832;1,2
3547908;Santo Antônio da Alegria;2010;12;1,91;12;1,91;0;0
3547908;Santo Antônio da Alegria;2011;12;1,89;12;1,89;0;0
3547908;Santo Antônio da Alegria;2012;12;1,88;12;1,88;0;0
3547908;Santo Antônio da Alegria;2013;12;1,87;12;1,87;0;0
3547908;Santo Antônio da Alegria;2014;12;1,86;12;1,86;0;0
3547908;Santo Antônio da Alegria;2015;12;1,85;12;1,85;0;0
3547908;Santo Antônio da Alegria;2016;12;1,84;12;1,84;0;0
3547908;Santo Antônio da Alegria;2017;21;3,21;21;3,21;0;0
3547908;Santo Antônio da Alegria;2018;21;3,2;21;3,2;0;0
3547908;Santo Antônio da Alegria;2019;19;2,88;19;2,88;0;0
3548005;Santo Antônio de Posse;2010;0;0;0;0;0;0
3548005;Santo Antônio de Posse;2011;0;0;0;0;0;0
3548005;Santo Antônio de Posse;2012;0;0;0;0;0;0
3548005;Santo Antônio de Posse;2013;0;0;0;0;0;0
3548005;Santo Antônio de Posse;2014;0;0;0;0;0;0
3548005;Santo Antônio de Posse;2015;0;0;0;0;0;0
3548005;Santo Antônio de Posse;2016;0;0;0;0;0;0
3548005;Santo Antônio de Posse;2017;0;0;0;0;0;0
3548005;Santo Antônio de Posse;2018;0;0;0;0;0;0
3548005;Santo Antônio de Posse;2019;0;0;0;0;0;0
3548054;Santo Antônio do Aracanguá;2010;0;0;0;0;0;0
3548054;Santo Antônio do Aracanguá;2011;0;0;0;0;0;0
3548054;Santo Antônio do Aracanguá;2012;0;0;0;0;0;0
3548054;Santo Antônio do Aracanguá;2013;0;0;0;0;0;0
3548054;Santo Antônio do Aracanguá;2014;0;0;0;0;0;0
3548054;Santo Antônio do Aracanguá;2015;0;0;0;0;0;0
3548054;Santo Antônio do Aracanguá;2016;0;0;0;0;0;0
3548054;Santo Antônio do Aracanguá;2017;0;0;0;0;0;0
3548054;Santo Antônio do Aracanguá;2018;0;0;0;0;0;0
3548054;Santo Antônio do Aracanguá;2019;0;0;0;0;0;0
3548104;Santo Antônio do Jardim;2010;0;0;0;0;0;0
3548104;Santo Antônio do Jardim;2011;0;0;0;0;0;0
3548104;Santo Antônio do Jardim;2012;0;0;0;0;0;0
3548104;Santo Antônio do Jardim;2013;0;0;0;0;0;0
3548104;Santo Antônio do Jardim;2014;0;0;0;0;0;0
3548104;Santo Antônio do Jardim;2015;0;0;0;0;0;0
3548104;Santo Antônio do Jardim;2016;0;0;0;0;0;0
3548104;Santo Antônio do Jardim;2017;0;0;0;0;0;0
3548104;Santo Antônio do Jardim;2018;0;0;0;0;0;0
3548104;Santo Antônio do Jardim;2019;0;0;0;0;0;0
3548203;Santo Antônio do Pinhal;2010;0;0;0;0;0;0
3548203;Santo Antônio do Pinhal;2011;0;0;0;0;0;0
3548203;Santo Antônio do Pinhal;2012;0;0;0;0;0;0
3548203;Santo Antônio do Pinhal;2013;0;0;0;0;0;0
3548203;Santo Antônio do Pinhal;2014;0;0;0;0;0;0
3548203;Santo Antônio do Pinhal;2015;0;0;0;0;0;0
3548203;Santo Antônio do Pinhal;2016;0;0;0;0;0;0
3548203;Santo Antônio do Pinhal;2017;0;0;0;0;0;0
3548203;Santo Antônio do Pinhal;2018;0;0;0;0;0;0
3548203;Santo Antônio do Pinhal;2019;0;0;0;0;0;0
3548302;Santo Expedito;2010;0;0;0;0;0;0
3548302;Santo Expedito;2011;0;0;0;0;0;0
3548302;Santo Expedito;2012;0;0;0;0;0;0
3548302;Santo Expedito;2013;0;0;0;0;0;0
3548302;Santo Expedito;2014;0;0;0;0;0;0
3548302;Santo Expedito;2015;0;0;0;0;0;0
3548302;Santo Expedito;2016;0;0;0;0;0;0
3548302;Santo Expedito;2017;0;0;0;0;0;0
3548302;Santo Expedito;2018;0;0;0;0;0;0
3548302;Santo Expedito;2019;0;0;0;0;0;0
3548401;Santópolis do Aguapeí;2010;0;0;0;0;0;0
3548401;Santópolis do Aguapeí;2011;0;0;0;0;0;0
3548401;Santópolis do Aguapeí;2012;0;0;0;0;0;0
3548401;Santópolis do Aguapeí;2013;0;0;0;0;0;0
3548401;Santópolis do Aguapeí;2014;0;0;0;0;0;0
3548401;Santópolis do Aguapeí;2015;0;0;0;0;0;0
3548401;Santópolis do Aguapeí;2016;0;0;0;0;0;0
3548401;Santópolis do Aguapeí;2017;0;0;0;0;0;0
3548401;Santópolis do Aguapeí;2018;0;0;0;0;0;0
3548401;Santópolis do Aguapeí;2019;0;0;0;0;0;0
3548500;Santos;2010;1692;4,03;816;1,95;876;2,09
3548500;Santos;2011;1624;3,86;734;1,75;890;2,12
3548500;Santos;2012;1643;3,9;737;1,75;906;2,15
3548500;Santos;2013;1613;3,82;767;1,82;846;2,01
3548500;Santos;2014;1662;3,93;800;1,89;862;2,04
3548500;Santos;2015;1636;3,86;799;1,89;837;1,98
3548500;Santos;2016;1644;3,87;814;1,92;830;1,95
3548500;Santos;2017;1672;3,93;852;2;820;1,93
3548500;Santos;2018;1738;4,07;874;2,05;864;2,03
3548500;Santos;2019;1716;4,01;858;2,01;858;2,01
3548609;São Bento do Sapucaí;2010;40;3,82;24;2,29;16;1,53
3548609;São Bento do Sapucaí;2011;40;3,82;24;2,29;16;1,53
3548609;São Bento do Sapucaí;2012;40;3,82;24;2,29;16;1,53
3548609;São Bento do Sapucaí;2013;40;3,82;26;2,48;14;1,34
3548609;São Bento do Sapucaí;2014;40;3,82;26;2,48;14;1,34
3548609;São Bento do Sapucaí;2015;40;3,82;26;2,48;14;1,34
3548609;São Bento do Sapucaí;2016;40;3,81;26;2,48;14;1,33
3548609;São Bento do Sapucaí;2017;40;3,81;26;2,48;14;1,33
3548609;São Bento do Sapucaí;2018;40;3,81;26;2,47;14;1,33
3548609;São Bento do Sapucaí;2019;40;3,8;26;2,47;14;1,33
3548708;São Bernardo do Campo;2010;1721;2,25;836;1,09;885;1,16
3548708;São Bernardo do Campo;2011;1631;2,12;761;0,99;870;1,13
3548708;São Bernardo do Campo;2012;1474;1,9;759;0,98;715;0,92
3548708;São Bernardo do Campo;2013;1596;2,04;729;0,93;867;1,11
3548708;São Bernardo do Campo;2014;1534;1,95;566;0,72;968;1,23
3548708;São Bernardo do Campo;2015;1528;1,93;569;0,72;959;1,21
3548708;São Bernardo do Campo;2016;1543;1,94;560;0,7;983;1,24
3548708;São Bernardo do Campo;2017;1558;1,95;593;0,74;965;1,21
3548708;São Bernardo do Campo;2018;1510;1,88;785;0,98;725;0,9
3548708;São Bernardo do Campo;2019;1583;1,96;588;0,73;995;1,23
3548807;São Caetano do Sul;2010;661;4,43;218;1,46;443;2,97
3548807;São Caetano do Sul;2011;529;3,54;150;1;379;2,54
3548807;São Caetano do Sul;2012;541;3,61;163;1,09;378;2,52
3548807;São Caetano do Sul;2013;565;3,77;187;1,25;378;2,52
3548807;São Caetano do Sul;2014;560;3,73;182;1,21;378;2,51
3548807;São Caetano do Sul;2015;424;2,82;182;1,21;242;1,61
3548807;São Caetano do Sul;2016;426;2,83;184;1,22;242;1,61
3548807;São Caetano do Sul;2017;571;3,78;183;1,21;388;2,57
3548807;São Caetano do Sul;2018;591;3,91;183;1,21;408;2,7
3548807;São Caetano do Sul;2019;618;4,09;177;1,17;441;2,92
3548906;São Carlos;2010;443;2;204;0,92;239;1,08
3548906;São Carlos;2011;443;1,98;204;0,91;239;1,07
3548906;São Carlos;2012;419;1,85;204;0,9;215;0,95
3548906;São Carlos;2013;419;1,83;204;0,89;215;0,94
3548906;São Carlos;2014;419;1,81;204;0,88;215;0,93
3548906;São Carlos;2015;419;1,8;204;0,87;215;0,92
3548906;São Carlos;2016;417;1,77;198;0,84;219;0,93
3548906;São Carlos;2017;450;1,9;231;0,97;219;0,92
3548906;São Carlos;2018;434;1,82;213;0,89;221;0,93
3548906;São Carlos;2019;436;1,81;211;0,88;225;0,93
3549003;São Francisco;2010;0;0;0;0;0;0
3549003;São Francisco;2011;0;0;0;0;0;0
3549003;São Francisco;2012;0;0;0;0;0;0
3549003;São Francisco;2013;0;0;0;0;0;0
3549003;São Francisco;2014;0;0;0;0;0;0
3549003;São Francisco;2015;0;0;0;0;0;0
3549003;São Francisco;2016;0;0;0;0;0;0
3549003;São Francisco;2017;0;0;0;0;0;0
3549003;São Francisco;2018;0;0;0;0;0;0
3549003;São Francisco;2019;0;0;0;0;0;0
3549102;São João da Boa Vista;2010;190;2,27;84;1;106;1,27
3549102;São João da Boa Vista;2011;190;2,26;84;1;106;1,26
3549102;São João da Boa Vista;2012;190;2,25;84;0,99;106;1,26
3549102;São João da Boa Vista;2013;198;2,33;94;1,11;104;1,23
3549102;São João da Boa Vista;2014;198;2,32;94;1,1;104;1,22
3549102;São João da Boa Vista;2015;199;2,32;94;1,1;105;1,23
3549102;São João da Boa Vista;2016;199;2,31;94;1,09;105;1,22
3549102;São João da Boa Vista;2017;199;2,3;94;1,09;105;1,22
3549102;São João da Boa Vista;2018;199;2,3;94;1,08;105;1,21
3549102;São João da Boa Vista;2019;199;2,29;94;1,08;105;1,21
3549201;São João das Duas Pontes;2010;0;0;0;0;0;0
3549201;São João das Duas Pontes;2011;0;0;0;0;0;0
3549201;São João das Duas Pontes;2012;0;0;0;0;0;0
3549201;São João das Duas Pontes;2013;0;0;0;0;0;0
3549201;São João das Duas Pontes;2014;0;0;0;0;0;0
3549201;São João das Duas Pontes;2015;0;0;0;0;0;0
3549201;São João das Duas Pontes;2016;0;0;0;0;0;0
3549201;São João das Duas Pontes;2017;0;0;0;0;0;0
3549201;São João das Duas Pontes;2018;0;0;0;0;0;0
3549201;São João das Duas Pontes;2019;0;0;0;0;0;0
3549250;São João de Iracema;2010;0;0;0;0;0;0
3549250;São João de Iracema;2011;0;0;0;0;0;0
3549250;São João de Iracema;2012;0;0;0;0;0;0
3549250;São João de Iracema;2013;0;0;0;0;0;0
3549250;São João de Iracema;2014;0;0;0;0;0;0
3549250;São João de Iracema;2015;0;0;0;0;0;0
3549250;São João de Iracema;2016;0;0;0;0;0;0
3549250;São João de Iracema;2017;0;0;0;0;0;0
3549250;São João de Iracema;2018;0;0;0;0;0;0
3549250;São João de Iracema;2019;0;0;0;0;0;0
3549300;São João do Pau d'Alho;2010;0;0;0;0;0;0
3549300;São João do Pau d'Alho;2011;0;0;0;0;0;0
3549300;São João do Pau d'Alho;2012;0;0;0;0;0;0
3549300;São João do Pau d'Alho;2013;0;0;0;0;0;0
3549300;São João do Pau d'Alho;2014;0;0;0;0;0;0
3549300;São João do Pau d'Alho;2015;0;0;0;0;0;0
3549300;São João do Pau d'Alho;2016;0;0;0;0;0;0
3549300;São João do Pau d'Alho;2017;0;0;0;0;0;0
3549300;São João do Pau d'Alho;2018;0;0;0;0;0;0
3549300;São João do Pau d'Alho;2019;0;0;0;0;0;0
3549409;São Joaquim da Barra;2010;120;2,58;92;1,98;28;0,6
3549409;São Joaquim da Barra;2011;115;2,45;68;1,45;47;1
3549409;São Joaquim da Barra;2012;115;2,43;68;1,44;47;0,99
3549409;São Joaquim da Barra;2013;115;2,41;68;1,43;47;0,99
3549409;São Joaquim da Barra;2014;115;2,39;68;1,41;47;0,98
3549409;São Joaquim da Barra;2015;115;2,37;68;1,4;47;0,97
3549409;São Joaquim da Barra;2016;115;2,35;68;1,39;47;0,96
3549409;São Joaquim da Barra;2017;115;2,34;68;1,38;47;0,95
3549409;São Joaquim da Barra;2018;115;2,32;68;1,37;47;0,95
3549409;São Joaquim da Barra;2019;115;2,3;68;1,36;47;0,94
3549508;São José da Bela Vista;2010;0;0;0;0;0;0
3549508;São José da Bela Vista;2011;0;0;0;0;0;0
3549508;São José da Bela Vista;2012;0;0;0;0;0;0
3549508;São José da Bela Vista;2013;0;0;0;0;0;0
3549508;São José da Bela Vista;2014;0;0;0;0;0;0
3549508;São José da Bela Vista;2015;0;0;0;0;0;0
3549508;São José da Bela Vista;2016;0;0;0;0;0;0
3549508;São José da Bela Vista;2017;0;0;0;0;0;0
3549508;São José da Bela Vista;2018;0;0;0;0;0;0
3549508;São José da Bela Vista;2019;0;0;0;0;0;0
3549607;São José do Barreiro;2010;0;0;0;0;0;0
3549607;São José do Barreiro;2011;0;0;0;0;0;0
3549607;São José do Barreiro;2012;0;0;0;0;0;0
3549607;São José do Barreiro;2013;0;0;0;0;0;0
3549607;São José do Barreiro;2014;0;0;0;0;0;0
3549607;São José do Barreiro;2015;0;0;0;0;0;0
3549607;São José do Barreiro;2016;0;0;0;0;0;0
3549607;São José do Barreiro;2017;0;0;0;0;0;0
3549607;São José do Barreiro;2018;0;0;0;0;0;0
3549607;São José do Barreiro;2019;0;0;0;0;0;0
3549706;São José do Rio Pardo;2010;145;2,79;89;1,72;56;1,08
3549706;São José do Rio Pardo;2011;145;2,79;89;1,71;56;1,08
3549706;São José do Rio Pardo;2012;145;2,78;89;1,71;56;1,07
3549706;São José do Rio Pardo;2013;145;2,77;89;1,7;56;1,07
3549706;São José do Rio Pardo;2014;145;2,76;89;1,7;56;1,07
3549706;São José do Rio Pardo;2015;145;2,76;89;1,69;56;1,06
3549706;São José do Rio Pardo;2016;136;2,58;81;1,54;55;1,04
3549706;São José do Rio Pardo;2017;136;2,57;81;1,53;55;1,04
3549706;São José do Rio Pardo;2018;136;2,57;81;1,53;55;1,04
3549706;São José do Rio Pardo;2019;136;2,56;81;1,53;55;1,04
3549805;São José do Rio Preto;2010;1537;3,77;1000;2,45;537;1,32
3549805;São José do Rio Preto;2011;1690;4,1;1146;2,78;544;1,32
3549805;São José do Rio Preto;2012;1695;4,07;992;2,38;703;1,69
3549805;São José do Rio Preto;2013;1726;4,1;992;2,36;734;1,74
3549805;São José do Rio Preto;2014;1784;4,19;997;2,34;787;1,85
3549805;São José do Rio Preto;2015;1861;4,32;997;2,32;864;2,01
3549805;São José do Rio Preto;2016;1820;4,2;916;2,11;904;2,08
3549805;São José do Rio Preto;2017;1856;4,24;870;1,99;986;2,25
3549805;São José do Rio Preto;2018;1850;4,2;871;1,98;979;2,22
3549805;São José do Rio Preto;2019;1905;4,29;886;1,99;1019;2,29
3549904;São José dos Campos;2010;1467;2,33;856;1,36;611;0,97
3549904;São José dos Campos;2011;1459;2,29;829;1,3;630;0,99
3549904;São José dos Campos;2012;1457;2,25;832;1,29;625;0,97
3549904;São José dos Campos;2013;1505;2,3;833;1,27;672;1,03
3549904;São José dos Campos;2014;1502;2,26;834;1,26;668;1,01
3549904;São José dos Campos;2015;1421;2,11;740;1,1;681;1,01
3549904;São José dos Campos;2016;1502;2,21;736;1,08;766;1,13
3549904;São José dos Campos;2017;1534;2,23;736;1,07;798;1,16
3549904;São José dos Campos;2018;1645;2,37;869;1,25;776;1,12
3549904;São José dos Campos;2019;1672;2,38;824;1,17;848;1,21
3549953;São Lourenço da Serra;2010;0;0;0;0;0;0
3549953;São Lourenço da Serra;2011;0;0;0;0;0;0
3549953;São Lourenço da Serra;2012;0;0;0;0;0;0
3549953;São Lourenço da Serra;2013;0;0;0;0;0;0
3549953;São Lourenço da Serra;2014;0;0;0;0;0;0
3549953;São Lourenço da Serra;2015;0;0;0;0;0;0
3549953;São Lourenço da Serra;2016;0;0;0;0;0;0
3549953;São Lourenço da Serra;2017;0;0;0;0;0;0
3549953;São Lourenço da Serra;2018;0;0;0;0;0;0
3549953;São Lourenço da Serra;2019;0;0;0;0;0;0
3550001;São Luiz do Paraitinga;2010;26;2,5;11;1,06;15;1,44
3550001;São Luiz do Paraitinga;2011;26;2,5;11;1,06;15;1,44
3550001;São Luiz do Paraitinga;2012;26;2,49;11;1,05;15;1,44
3550001;São Luiz do Paraitinga;2013;26;2,49;11;1,05;15;1,44
3550001;São Luiz do Paraitinga;2014;26;2,49;11;1,05;15;1,43
3550001;São Luiz do Paraitinga;2015;26;2,48;11;1,05;15;1,43
3550001;São Luiz do Paraitinga;2016;26;2,48;11;1,05;15;1,43
3550001;São Luiz do Paraitinga;2017;26;2,47;11;1,05;15;1,43
3550001;São Luiz do Paraitinga;2018;26;2,47;11;1,04;15;1,42
3550001;São Luiz do Paraitinga;2019;25;2,37;16;1,52;9;0,85
3550100;São Manuel;2010;75;1,96;58;1,51;17;0,44
3550100;São Manuel;2011;34;0,88;22;0,57;12;0,31
3550100;São Manuel;2012;36;0,93;22;0,57;14;0,36
3550100;São Manuel;2013;43;1,11;36;0,93;7;0,18
3550100;São Manuel;2014;43;1,11;36;0,93;7;0,18
3550100;São Manuel;2015;43;1,1;36;0,92;7;0,18
3550100;São Manuel;2016;43;1,1;36;0,92;7;0,18
3550100;São Manuel;2017;35;0,89;31;0,79;4;0,1
3550100;São Manuel;2018;35;0,89;31;0,79;4;0,1
3550100;São Manuel;2019;35;0,89;31;0,79;4;0,1
3550209;São Miguel Arcanjo;2010;6;0,19;6;0,19;0;0
3550209;São Miguel Arcanjo;2011;6;0,19;6;0,19;0;0
3550209;São Miguel Arcanjo;2012;6;0,19;6;0,19;0;0
3550209;São Miguel Arcanjo;2013;46;1,46;46;1,46;0;0
3550209;São Miguel Arcanjo;2014;25;0,79;25;0,79;0;0
3550209;São Miguel Arcanjo;2015;50;1,58;50;1,58;0;0
3550209;São Miguel Arcanjo;2016;42;1,32;42;1,32;0;0
3550209;São Miguel Arcanjo;2017;54;1,7;54;1,7;0;0
3550209;São Miguel Arcanjo;2018;54;1,69;54;1,69;0;0
3550209;São Miguel Arcanjo;2019;50;1,57;50;1,57;0;0
3550308;São Paulo;2010;29562;2,63;15708;1,4;13854;1,23
3550308;São Paulo;2011;29497;2,61;15657;1,38;13840;1,22
3550308;São Paulo;2012;28669;2,52;15084;1,33;13585;1,19
3550308;São Paulo;2013;28700;2,51;15195;1,33;13505;1,18
3550308;São Paulo;2014;29327;2,55;15084;1,31;14243;1,24
3550308;São Paulo;2015;29392;2,54;15698;1,36;13694;1,18
3550308;São Paulo;2016;28766;2,47;15147;1,3;13619;1,17
3550308;São Paulo;2017;29203;2,5;15166;1,3;14037;1,2
3550308;São Paulo;2018;29203;2,48;14846;1,26;14357;1,22
3550308;São Paulo;2019;28494;2,41;14530;1,23;13964;1,18
3550407;São Pedro;2010;81;2,56;62;1,96;19;0,6
3550407;São Pedro;2011;62;1,94;37;1,16;25;0,78
3550407;São Pedro;2012;62;1,93;37;1,15;25;0,78
3550407;São Pedro;2013;62;1,91;37;1,14;25;0,77
3550407;São Pedro;2014;62;1,89;37;1,13;25;0,76
3550407;São Pedro;2015;62;1,88;37;1,12;25;0,76
3550407;São Pedro;2016;62;1,86;37;1,11;25;0,75
3550407;São Pedro;2017;62;1,85;37;1,1;25;0,75
3550407;São Pedro;2018;62;1,84;37;1,1;25;0,74
3550407;São Pedro;2019;62;1,83;40;1,18;22;0,65
3550506;São Pedro do Turvo;2010;0;0;0;0;0;0
3550506;São Pedro do Turvo;2011;0;0;0;0;0;0
3550506;São Pedro do Turvo;2012;0;0;0;0;0;0
3550506;São Pedro do Turvo;2013;0;0;0;0;0;0
3550506;São Pedro do Turvo;2014;0;0;0;0;0;0
3550506;São Pedro do Turvo;2015;0;0;0;0;0;0
3550506;São Pedro do Turvo;2016;0;0;0;0;0;0
3550506;São Pedro do Turvo;2017;0;0;0;0;0;0
3550506;São Pedro do Turvo;2018;0;0;0;0;0;0
3550506;São Pedro do Turvo;2019;0;0;0;0;0;0
3550605;São Roque;2010;94;1,19;54;0,69;40;0,51
3550605;São Roque;2011;104;1,31;54;0,68;50;0,63
3550605;São Roque;2012;103;1,28;54;0,67;49;0,61
3550605;São Roque;2013;103;1,26;54;0,66;49;0,6
3550605;São Roque;2014;103;1,25;54;0,65;49;0,59
3550605;São Roque;2015;89;1,07;41;0,49;48;0,57
3550605;São Roque;2016;89;1,06;41;0,49;48;0,57
3550605;São Roque;2017;88;1,03;49;0,58;39;0,46
3550605;São Roque;2018;88;1,03;49;0,57;39;0,45
3550605;São Roque;2019;97;1,12;46;0,53;51;0,59
3550704;São Sebastião;2010;110;1,49;99;1,34;11;0,15
3550704;São Sebastião;2011;110;1,46;99;1,32;11;0,15
3550704;São Sebastião;2012;101;1,32;93;1,22;8;0,1
3550704;São Sebastião;2013;101;1,3;93;1,19;8;0,1
3550704;São Sebastião;2014;101;1,27;93;1,17;8;0,1
3550704;São Sebastião;2015;101;1,25;93;1,15;8;0,1
3550704;São Sebastião;2016;101;1,23;93;1,13;8;0,1
3550704;São Sebastião;2017;101;1,21;93;1,12;8;0,1
3550704;São Sebastião;2018;101;1,19;93;1,1;8;0,09
3550704;São Sebastião;2019;101;1,18;93;1,08;8;0,09
3550803;São Sebastião da Grama;2010;30;2,48;26;2,15;4;0,33
3550803;São Sebastião da Grama;2011;30;2,48;26;2,15;4;0,33
3550803;São Sebastião da Grama;2012;30;2,49;26;2,16;4;0,33
3550803;São Sebastião da Grama;2013;30;2,49;26;2,16;4;0,33
3550803;São Sebastião da Grama;2014;30;2,5;26;2,17;4;0,33
3550803;São Sebastião da Grama;2015;30;2,51;26;2,17;4;0,33
3550803;São Sebastião da Grama;2016;30;2,51;26;2,17;4;0,33
3550803;São Sebastião da Grama;2017;30;2,51;26;2,17;4;0,33
3550803;São Sebastião da Grama;2018;30;2,51;26;2,18;4;0,33
3550803;São Sebastião da Grama;2019;30;2,51;26;2,18;4;0,33
3550902;São Simão;2010;40;2,79;32;2,23;8;0,56
3550902;São Simão;2011;40;2,78;32;2,22;8;0,56
3550902;São Simão;2012;40;2,77;32;2,22;8;0,55
3550902;São Simão;2013;40;2,76;32;2,21;8;0,55
3550902;São Simão;2014;40;2,75;32;2,2;8;0,55
3550902;São Simão;2015;50;3,43;38;2,61;12;0,82
3550902;São Simão;2016;50;3,42;38;2,6;12;0,82
3550902;São Simão;2017;50;3,4;38;2,59;12;0,82
3550902;São Simão;2018;50;3,39;38;2,58;12;0,81
3550902;São Simão;2019;40;2,7;32;2,16;8;0,54
3551009;São Vicente;2010;174;0,52;134;0,4;40;0,12
3551009;São Vicente;2011;218;0,65;166;0,5;52;0,16
3551009;São Vicente;2012;220;0,65;165;0,49;55;0,16
3551009;São Vicente;2013;331;0,97;276;0,81;55;0,16
3551009;São Vicente;2014;287;0,84;170;0,5;117;0,34
3551009;São Vicente;2015;287;0,83;170;0,49;117;0,34
3551009;São Vicente;2016;283;0,81;166;0,48;117;0,34
3551009;São Vicente;2017;283;0,81;166;0,47;117;0,33
3551009;São Vicente;2018;281;0,8;150;0,43;131;0,37
3551009;São Vicente;2019;269;0,76;158;0,44;111;0,31
3551108;Sarapuí;2010;0;0;0;0;0;0
3551108;Sarapuí;2011;0;0;0;0;0;0
3551108;Sarapuí;2012;0;0;0;0;0;0
3551108;Sarapuí;2013;0;0;0;0;0;0
3551108;Sarapuí;2014;0;0;0;0;0;0
3551108;Sarapuí;2015;0;0;0;0;0;0
3551108;Sarapuí;2016;0;0;0;0;0;0
3551108;Sarapuí;2017;0;0;0;0;0;0
3551108;Sarapuí;2018;0;0;0;0;0;0
3551108;Sarapuí;2019;0;0;0;0;0;0
3551207;Sarutaiá;2010;0;0;0;0;0;0
3551207;Sarutaiá;2011;0;0;0;0;0;0
3551207;Sarutaiá;2012;0;0;0;0;0;0
3551207;Sarutaiá;2013;0;0;0;0;0;0
3551207;Sarutaiá;2014;0;0;0;0;0;0
3551207;Sarutaiá;2015;0;0;0;0;0;0
3551207;Sarutaiá;2016;0;0;0;0;0;0
3551207;Sarutaiá;2017;0;0;0;0;0;0
3551207;Sarutaiá;2018;0;0;0;0;0;0
3551207;Sarutaiá;2019;0;0;0;0;0;0
3551306;Sebastianópolis do Sul;2010;0;0;0;0;0;0
3551306;Sebastianópolis do Sul;2011;0;0;0;0;0;0
3551306;Sebastianópolis do Sul;2012;0;0;0;0;0;0
3551306;Sebastianópolis do Sul;2013;0;0;0;0;0;0
3551306;Sebastianópolis do Sul;2014;0;0;0;0;0;0
3551306;Sebastianópolis do Sul;2015;0;0;0;0;0;0
3551306;Sebastianópolis do Sul;2016;0;0;0;0;0;0
3551306;Sebastianópolis do Sul;2017;0;0;0;0;0;0
3551306;Sebastianópolis do Sul;2018;0;0;0;0;0;0
3551306;Sebastianópolis do Sul;2019;0;0;0;0;0;0
3551405;Serra Azul;2010;0;0;0;0;0;0
3551405;Serra Azul;2011;0;0;0;0;0;0
3551405;Serra Azul;2012;0;0;0;0;0;0
3551405;Serra Azul;2013;0;0;0;0;0;0
3551405;Serra Azul;2014;0;0;0;0;0;0
3551405;Serra Azul;2015;0;0;0;0;0;0
3551405;Serra Azul;2016;0;0;0;0;0;0
3551405;Serra Azul;2017;0;0;0;0;0;0
3551405;Serra Azul;2018;0;0;0;0;0;0
3551405;Serra Azul;2019;0;0;0;0;0;0
3551603;Serra Negra;2010;65;2,47;49;1,86;16;0,61
3551603;Serra Negra;2011;55;2,08;42;1,59;13;0,49
3551603;Serra Negra;2012;55;2,07;42;1,58;13;0,49
3551603;Serra Negra;2013;55;2,06;42;1,57;13;0,49
3551603;Serra Negra;2014;49;1,82;33;1,23;16;0,6
3551603;Serra Negra;2015;49;1,82;33;1,22;16;0,59
3551603;Serra Negra;2016;49;1,81;33;1,22;16;0,59
3551603;Serra Negra;2017;49;1,8;33;1,21;16;0,59
3551603;Serra Negra;2018;49;1,8;33;1,21;16;0,59
3551603;Serra Negra;2019;49;1,79;33;1,21;16;0,59
3551504;Serrana;2010;58;1,49;43;1,11;15;0,39
3551504;Serrana;2011;58;1,47;43;1,09;15;0,38
3551504;Serrana;2012;58;1,45;43;1,08;15;0,38
3551504;Serrana;2013;58;1,43;43;1,06;15;0,37
3551504;Serrana;2014;58;1,41;43;1,04;15;0,36
3551504;Serrana;2015;58;1,39;43;1,03;15;0,36
3551504;Serrana;2016;58;1,37;43;1,02;15;0,35
3551504;Serrana;2017;58;1,35;43;1;15;0,35
3551504;Serrana;2018;55;1,27;42;0,97;13;0,3
3551504;Serrana;2019;125;2,85;112;2,55;13;0,3
3551702;Sertãozinho;2010;155;1,41;75;0,68;80;0,73
3551702;Sertãozinho;2011;155;1,39;75;0,67;80;0,72
3551702;Sertãozinho;2012;155;1,38;75;0,67;80;0,71
3551702;Sertãozinho;2013;155;1,36;75;0,66;80;0,7
3551702;Sertãozinho;2014;157;1,36;64;0,55;93;0,81
3551702;Sertãozinho;2015;157;1,34;64;0,55;93;0,8
3551702;Sertãozinho;2016;157;1,33;64;0,54;93;0,79
3551702;Sertãozinho;2017;162;1,36;66;0,55;96;0,81
3551702;Sertãozinho;2018;162;1,35;66;0,55;96;0,8
3551702;Sertãozinho;2019;162;1,34;66;0,54;96;0,79
3551801;Sete Barras;2010;0;0;0;0;0;0
3551801;Sete Barras;2011;0;0;0;0;0;0
3551801;Sete Barras;2012;0;0;0;0;0;0
3551801;Sete Barras;2013;0;0;0;0;0;0
3551801;Sete Barras;2014;0;0;0;0;0;0
3551801;Sete Barras;2015;0;0;0;0;0;0
3551801;Sete Barras;2016;0;0;0;0;0;0
3551801;Sete Barras;2017;0;0;0;0;0;0
3551801;Sete Barras;2018;0;0;0;0;0;0
3551801;Sete Barras;2019;0;0;0;0;0;0
3551900;Severínia;2010;0;0;0;0;0;0
3551900;Severínia;2011;0;0;0;0;0;0
3551900;Severínia;2012;0;0;0;0;0;0
3551900;Severínia;2013;0;0;0;0;0;0
3551900;Severínia;2014;0;0;0;0;0;0
3551900;Severínia;2015;0;0;0;0;0;0
3551900;Severínia;2016;0;0;0;0;0;0
3551900;Severínia;2017;0;0;0;0;0;0
3551900;Severínia;2018;0;0;0;0;0;0
3551900;Severínia;2019;0;0;0;0;0;0
3552007;Silveiras;2010;12;2,07;3;0,52;9;1,55
3552007;Silveiras;2011;12;2,06;3;0,51;9;1,54
3552007;Silveiras;2012;3;0,51;3;0,51;0;0
3552007;Silveiras;2013;3;0,51;3;0,51;0;0
3552007;Silveiras;2014;3;0,5;3;0,5;0;0
3552007;Silveiras;2015;3;0,5;3;0,5;0;0
3552007;Silveiras;2016;3;0,5;3;0,5;0;0
3552007;Silveiras;2017;3;0,49;3;0,49;0;0
3552007;Silveiras;2018;2;0,33;2;0,33;0;0
3552007;Silveiras;2019;2;0,32;2;0,32;0;0
3552106;Socorro;2010;62;1,69;62;1,69;0;0
3552106;Socorro;2011;62;1,68;54;1,46;8;0,22
3552106;Socorro;2012;62;1,67;54;1,45;8;0,22
3552106;Socorro;2013;62;1,66;54;1,45;8;0,21
3552106;Socorro;2014;62;1,65;54;1,44;8;0,21
3552106;Socorro;2015;62;1,64;54;1,43;8;0,21
3552106;Socorro;2016;62;1,63;54;1,42;8;0,21
3552106;Socorro;2017;70;1,83;63;1,65;7;0,18
3552106;Socorro;2018;70;1,82;63;1,64;7;0,18
3552106;Socorro;2019;70;1,81;63;1,63;7;0,18
3552205;Sorocaba;2010;2583;4,41;2158;3,68;425;0,73
3552205;Sorocaba;2011;2588;4,36;2158;3,64;430;0,72
3552205;Sorocaba;2012;2590;4,31;2159;3,59;431;0,72
3552205;Sorocaba;2013;2431;4;1896;3,12;535;0,88
3552205;Sorocaba;2014;2223;3,61;1516;2,46;707;1,15
3552205;Sorocaba;2015;1924;3,08;1165;1,87;759;1,22
3552205;Sorocaba;2016;1572;2,49;1021;1,62;551;0,87
3552205;Sorocaba;2017;1455;2,28;892;1,4;563;0,88
3552205;Sorocaba;2018;1414;2,19;845;1,31;569;0,88
3552205;Sorocaba;2019;1429;2,19;853;1,31;576;0,88
3552304;Sud Mennucci;2010;20;2,69;20;2,69;0;0
3552304;Sud Mennucci;2011;20;2,68;20;2,68;0;0
3552304;Sud Mennucci;2012;20;2,67;20;2,67;0;0
3552304;Sud Mennucci;2013;20;2,66;20;2,66;0;0
3552304;Sud Mennucci;2014;20;2,65;20;2,65;0;0
3552304;Sud Mennucci;2015;20;2,64;20;2,64;0;0
3552304;Sud Mennucci;2016;20;2,63;20;2,63;0;0
3552304;Sud Mennucci;2017;22;2,88;20;2,62;2;0,26
3552304;Sud Mennucci;2018;22;2,87;20;2,61;2;0,26
3552304;Sud Mennucci;2019;22;2,86;20;2,6;2;0,26
3552403;Sumaré;2010;184;0,76;180;0,75;4;0,02
3552403;Sumaré;2011;184;0,75;180;0,73;4;0,02
3552403;Sumaré;2012;184;0,74;180;0,72;4;0,02
3552403;Sumaré;2013;184;0,72;180;0,71;4;0,02
3552403;Sumaré;2014;189;0,73;172;0,66;17;0,07
3552403;Sumaré;2015;189;0,72;172;0,65;17;0,06
3552403;Sumaré;2016;181;0,68;172;0,64;9;0,03
3552403;Sumaré;2017;181;0,67;172;0,63;9;0,03
3552403;Sumaré;2018;177;0,64;172;0,63;5;0,02
3552403;Sumaré;2019;177;0,63;172;0,62;5;0,02
3552551;Suzanápolis;2010;0;0;0;0;0;0
3552551;Suzanápolis;2011;0;0;0;0;0;0
3552551;Suzanápolis;2012;0;0;0;0;0;0
3552551;Suzanápolis;2013;0;0;0;0;0;0
3552551;Suzanápolis;2014;0;0;0;0;0;0
3552551;Suzanápolis;2015;0;0;0;0;0;0
3552551;Suzanápolis;2016;0;0;0;0;0;0
3552551;Suzanápolis;2017;0;0;0;0;0;0
3552551;Suzanápolis;2018;0;0;0;0;0;0
3552551;Suzanápolis;2019;0;0;0;0;0;0
3552502;Suzano;2010;330;1,26;217;0,83;113;0,43
3552502;Suzano;2011;188;0,71;119;0,45;69;0,26
3552502;Suzano;2012;187;0,7;106;0,4;81;0,3
3552502;Suzano;2013;170;0,63;79;0,29;91;0,34
3552502;Suzano;2014;173;0,63;88;0,32;85;0,31
3552502;Suzano;2015;173;0,62;84;0,3;89;0,32
3552502;Suzano;2016;184;0,66;84;0,3;100;0,36
3552502;Suzano;2017;161;0,57;67;0,24;94;0,33
3552502;Suzano;2018;150;0,53;67;0,23;83;0,29
3552502;Suzano;2019;139;0,48;61;0,21;78;0,27
3552601;Tabapuã;2010;30;2,64;11;0,97;19;1,67
3552601;Tabapuã;2011;30;2,63;11;0,96;19;1,66
3552601;Tabapuã;2012;30;2,61;11;0,96;19;1,66
3552601;Tabapuã;2013;30;2,6;11;0,95;19;1,65
3552601;Tabapuã;2014;30;2,58;9;0,78;21;1,81
3552601;Tabapuã;2015;30;2,57;9;0,77;21;1,8
3552601;Tabapuã;2016;30;2,56;9;0,77;21;1,79
3552601;Tabapuã;2017;30;2,55;11;0,94;19;1,62
3552601;Tabapuã;2018;30;2,54;11;0,93;19;1,61
3552601;Tabapuã;2019;30;2,53;11;0,93;19;1,6
3552700;Tabatinga;2010;35;2,39;22;1,5;13;0,89
3552700;Tabatinga;2011;35;2,37;22;1,49;13;0,88
3552700;Tabatinga;2012;35;2,35;22;1,47;13;0,87
3552700;Tabatinga;2013;35;2,33;22;1,46;13;0,86
3552700;Tabatinga;2014;35;2,31;22;1,45;13;0,86
3552700;Tabatinga;2015;35;2,29;22;1,44;13;0,85
3552700;Tabatinga;2016;35;2,27;22;1,43;13;0,84
3552700;Tabatinga;2017;35;2,25;22;1,42;13;0,84
3552700;Tabatinga;2018;35;2,24;22;1,41;13;0,83
3552700;Tabatinga;2019;35;2,22;22;1,39;13;0,82
3552809;Taboão da Serra;2010;572;2,34;338;1,38;234;0,96
3552809;Taboão da Serra;2011;569;2,29;338;1,36;231;0,93
3552809;Taboão da Serra;2012;563;2,23;332;1,32;231;0,92
3552809;Taboão da Serra;2013;563;2,2;332;1,3;231;0,9
3552809;Taboão da Serra;2014;570;2,19;339;1,3;231;0,89
3552809;Taboão da Serra;2015;505;1,91;334;1,26;171;0,65
3552809;Taboão da Serra;2016;387;1,44;334;1,24;53;0,2
3552809;Taboão da Serra;2017;495;1,82;334;1,23;161;0,59
3552809;Taboão da Serra;2018;495;1,79;334;1,21;161;0,58
3552809;Taboão da Serra;2019;482;1,72;321;1,15;161;0,58
3552908;Taciba;2010;0;0;0;0;0;0
3552908;Taciba;2011;0;0;0;0;0;0
3552908;Taciba;2012;0;0;0;0;0;0
3552908;Taciba;2013;0;0;0;0;0;0
3552908;Taciba;2014;0;0;0;0;0;0
3552908;Taciba;2015;0;0;0;0;0;0
3552908;Taciba;2016;0;0;0;0;0;0
3552908;Taciba;2017;0;0;0;0;0;0
3552908;Taciba;2018;0;0;0;0;0;0
3552908;Taciba;2019;0;0;0;0;0;0
3553005;Taguaí;2010;16;1,48;11;1,02;5;0,46
3553005;Taguaí;2011;16;1,45;11;1;5;0,45
3553005;Taguaí;2012;17;1,5;12;1,06;5;0,44
3553005;Taguaí;2013;31;2,68;24;2,07;7;0,6
3553005;Taguaí;2014;29;2,45;24;2,02;5;0,42
3553005;Taguaí;2015;29;2,39;24;1,98;5;0,41
3553005;Taguaí;2016;29;2,34;24;1,94;5;0,4
3553005;Taguaí;2017;29;2,3;24;1,91;5;0,4
3553005;Taguaí;2018;29;2,26;24;1,87;5;0,39
3553005;Taguaí;2019;29;2,22;24;1,84;5;0,38
3553104;Taiaçu;2010;0;0;0;0;0;0
3553104;Taiaçu;2011;0;0;0;0;0;0
3553104;Taiaçu;2012;0;0;0;0;0;0
3553104;Taiaçu;2013;0;0;0;0;0;0
3553104;Taiaçu;2014;0;0;0;0;0;0
3553104;Taiaçu;2015;0;0;0;0;0;0
3553104;Taiaçu;2016;0;0;0;0;0;0
3553104;Taiaçu;2017;0;0;0;0;0;0
3553104;Taiaçu;2018;0;0;0;0;0;0
3553104;Taiaçu;2019;0;0;0;0;0;0
3553203;Taiúva;2010;11;2,02;10;1,84;1;0,18
3553203;Taiúva;2011;11;1,92;10;1,75;1;0,17
3553203;Taiúva;2012;4;0,66;4;0,66;0;0
3553203;Taiúva;2013;4;0,63;4;0,63;0;0
3553203;Taiúva;2014;4;0,63;4;0,63;0;0
3553203;Taiúva;2015;4;0,63;4;0,63;0;0
3553203;Taiúva;2016;4;0,63;4;0,63;0;0
3553203;Taiúva;2017;4;0,63;4;0,63;0;0
3553203;Taiúva;2018;4;0,63;4;0,63;0;0
3553203;Taiúva;2019;4;0,64;4;0,64;0;0
3553302;Tambaú;2010;36;1,61;23;1,03;13;0,58
3553302;Tambaú;2011;36;1,6;23;1,03;13;0,58
3553302;Tambaú;2012;36;1,6;23;1,02;13;0,58
3553302;Tambaú;2013;34;1,51;25;1,11;9;0,4
3553302;Tambaú;2014;36;1,6;25;1,11;11;0,49
3553302;Tambaú;2015;36;1,59;25;1,11;11;0,49
3553302;Tambaú;2016;36;1,59;25;1,11;11;0,49
3553302;Tambaú;2017;36;1,59;25;1,1;11;0,49
3553302;Tambaú;2018;36;1,59;25;1,1;11;0,48
3553302;Tambaú;2019;36;1,58;25;1,1;11;0,48
3553401;Tanabi;2010;72;2,99;38;1,58;34;1,41
3553401;Tanabi;2011;72;2,98;38;1,57;34;1,41
3553401;Tanabi;2012;72;2,96;38;1,56;34;1,4
3553401;Tanabi;2013;72;2,95;38;1,56;34;1,39
3553401;Tanabi;2014;72;2,93;36;1,47;36;1,47
3553401;Tanabi;2015;72;2,92;32;1,3;40;1,62
3553401;Tanabi;2016;72;2,91;30;1,21;42;1,7
3553401;Tanabi;2017;72;2,9;30;1,21;42;1,69
3553401;Tanabi;2018;72;2,89;30;1,2;42;1,68
3553401;Tanabi;2019;72;2,88;30;1,2;42;1,68
3553500;Tapiraí;2010;0;0;0;0;0;0
3553500;Tapiraí;2011;0;0;0;0;0;0
3553500;Tapiraí;2012;0;0;0;0;0;0
3553500;Tapiraí;2013;0;0;0;0;0;0
3553500;Tapiraí;2014;0;0;0;0;0;0
3553500;Tapiraí;2015;0;0;0;0;0;0
3553500;Tapiraí;2016;0;0;0;0;0;0
3553500;Tapiraí;2017;0;0;0;0;0;0
3553500;Tapiraí;2018;0;0;0;0;0;0
3553500;Tapiraí;2019;0;0;0;0;0;0
3553609;Tapiratiba;2010;34;2,67;21;1,65;13;1,02
3553609;Tapiratiba;2011;34;2,67;21;1,65;13;1,02
3553609;Tapiratiba;2012;34;2,68;21;1,65;13;1,02
3553609;Tapiratiba;2013;24;1,89;18;1,42;6;0,47
3553609;Tapiratiba;2014;24;1,89;18;1,42;6;0,47
3553609;Tapiratiba;2015;24;1,9;19;1,5;5;0,4
3553609;Tapiratiba;2016;24;1,9;19;1,5;5;0,4
3553609;Tapiratiba;2017;24;1,9;19;1,5;5;0,4
3553609;Tapiratiba;2018;24;1,9;19;1,5;5;0,4
3553609;Tapiratiba;2019;16;1,27;13;1,03;3;0,24
3553658;Taquaral;2010;0;0;0;0;0;0
3553658;Taquaral;2011;0;0;0;0;0;0
3553658;Taquaral;2012;0;0;0;0;0;0
3553658;Taquaral;2013;0;0;0;0;0;0
3553658;Taquaral;2014;0;0;0;0;0;0
3553658;Taquaral;2015;0;0;0;0;0;0
3553658;Taquaral;2016;0;0;0;0;0;0
3553658;Taquaral;2017;0;0;0;0;0;0
3553658;Taquaral;2018;0;0;0;0;0;0
3553658;Taquaral;2019;0;0;0;0;0;0
3553708;Taquaritinga;2010;163;3,02;119;2,2;44;0,82
3553708;Taquaritinga;2011;163;3,02;119;2,2;44;0,81
3553708;Taquaritinga;2012;116;2,15;69;1,28;47;0,87
3553708;Taquaritinga;2013;120;2,22;73;1,35;47;0,87
3553708;Taquaritinga;2014;124;2,29;73;1,35;51;0,94
3553708;Taquaritinga;2015;124;2,29;73;1,35;51;0,94
3553708;Taquaritinga;2016;124;2,29;73;1,35;51;0,94
3553708;Taquaritinga;2017;124;2,28;73;1,34;51;0,94
3553708;Taquaritinga;2018;124;2,28;72;1,32;52;0,96
3553708;Taquaritinga;2019;124;2,28;72;1,32;52;0,96
3553807;Taquarituba;2010;53;2,38;35;1,57;18;0,81
3553807;Taquarituba;2011;55;2,46;36;1,61;19;0,85
3553807;Taquarituba;2012;55;2,45;36;1,6;19;0,85
3553807;Taquarituba;2013;54;2,39;36;1,59;18;0,8
3553807;Taquarituba;2014;53;2,34;32;1,41;21;0,93
3553807;Taquarituba;2015;53;2,33;32;1,4;21;0,92
3553807;Taquarituba;2016;53;2,32;32;1,4;21;0,92
3553807;Taquarituba;2017;53;2,31;32;1,39;21;0,92
3553807;Taquarituba;2018;49;2,13;31;1,35;18;0,78
3553807;Taquarituba;2019;49;2,12;31;1,34;18;0,78
3553856;Taquarivaí;2010;0;0;0;0;0;0
3553856;Taquarivaí;2011;0;0;0;0;0;0
3553856;Taquarivaí;2012;0;0;0;0;0;0
3553856;Taquarivaí;2013;0;0;0;0;0;0
3553856;Taquarivaí;2014;0;0;0;0;0;0
3553856;Taquarivaí;2015;0;0;0;0;0;0
3553856;Taquarivaí;2016;0;0;0;0;0;0
3553856;Taquarivaí;2017;0;0;0;0;0;0
3553856;Taquarivaí;2018;0;0;0;0;0;0
3553856;Taquarivaí;2019;0;0;0;0;0;0
3553906;Tarabai;2010;0;0;0;0;0;0
3553906;Tarabai;2011;0;0;0;0;0;0
3553906;Tarabai;2012;0;0;0;0;0;0
3553906;Tarabai;2013;0;0;0;0;0;0
3553906;Tarabai;2014;0;0;0;0;0;0
3553906;Tarabai;2015;0;0;0;0;0;0
3553906;Tarabai;2016;0;0;0;0;0;0
3553906;Tarabai;2017;0;0;0;0;0;0
3553906;Tarabai;2018;0;0;0;0;0;0
3553906;Tarabai;2019;0;0;0;0;0;0
3553955;Tarumã;2010;0;0;0;0;0;0
3553955;Tarumã;2011;0;0;0;0;0;0
3553955;Tarumã;2012;0;0;0;0;0;0
3553955;Tarumã;2013;0;0;0;0;0;0
3553955;Tarumã;2014;0;0;0;0;0;0
3553955;Tarumã;2015;0;0;0;0;0;0
3553955;Tarumã;2016;0;0;0;0;0;0
3553955;Tarumã;2017;0;0;0;0;0;0
3553955;Tarumã;2018;0;0;0;0;0;0
3553955;Tarumã;2019;0;0;0;0;0;0
3554003;Tatuí;2010;135;1,26;90;0,84;45;0,42
3554003;Tatuí;2011;135;1,24;90;0,83;45;0,41
3554003;Tatuí;2012;159;1,45;100;0,91;59;0,54
3554003;Tatuí;2013;208;1,87;93;0,84;115;1,03
3554003;Tatuí;2014;205;1,82;85;0,76;120;1,07
3554003;Tatuí;2015;198;1,74;85;0,75;113;0,99
3554003;Tatuí;2016;179;1,56;91;0,79;88;0,76
3554003;Tatuí;2017;177;1,52;114;0,98;63;0,54
3554003;Tatuí;2018;147;1,25;92;0,78;55;0,47
3554003;Tatuí;2019;129;1,09;78;0,66;51;0,43
3554102;Taubaté;2010;484;1,74;287;1,03;197;0,71
3554102;Taubaté;2011;499;1,77;299;1,06;200;0,71
3554102;Taubaté;2012;486;1,71;319;1,12;167;0,59
3554102;Taubaté;2013;452;1,57;325;1,13;127;0,44
3554102;Taubaté;2014;467;1,61;325;1,12;142;0,49
3554102;Taubaté;2015;497;1,69;325;1,11;172;0,59
3554102;Taubaté;2016;479;1,62;325;1,1;154;0,52
3554102;Taubaté;2017;493;1,65;325;1,09;168;0,56
3554102;Taubaté;2018;504;1,67;325;1,08;179;0,59
3554102;Taubaté;2019;509;1,67;330;1,08;179;0,59
3554201;Tejupá;2010;0;0;0;0;0;0
3554201;Tejupá;2011;0;0;0;0;0;0
3554201;Tejupá;2012;0;0;0;0;0;0
3554201;Tejupá;2013;0;0;0;0;0;0
3554201;Tejupá;2014;0;0;0;0;0;0
3554201;Tejupá;2015;0;0;0;0;0;0
3554201;Tejupá;2016;0;0;0;0;0;0
3554201;Tejupá;2017;0;0;0;0;0;0
3554201;Tejupá;2018;0;0;0;0;0;0
3554201;Tejupá;2019;0;0;0;0;0;0
3554300;Teodoro Sampaio;2010;58;2,71;52;2,43;6;0,28
3554300;Teodoro Sampaio;2011;58;2,7;52;2,42;6;0,28
3554300;Teodoro Sampaio;2012;58;2,69;52;2,41;6;0,28
3554300;Teodoro Sampaio;2013;58;2,67;52;2,4;6;0,28
3554300;Teodoro Sampaio;2014;58;2,66;52;2,38;6;0,28
3554300;Teodoro Sampaio;2015;58;2,64;52;2,37;6;0,27
3554300;Teodoro Sampaio;2016;58;2,63;52;2,36;6;0,27
3554300;Teodoro Sampaio;2017;58;2,62;52;2,35;6;0,27
3554300;Teodoro Sampaio;2018;58;2,61;52;2,34;6;0,27
3554300;Teodoro Sampaio;2019;58;2,6;52;2,33;6;0,27
3554409;Terra Roxa;2010;34;4;30;3,53;4;0,47
3554409;Terra Roxa;2011;34;3,97;30;3,5;4;0,47
3554409;Terra Roxa;2012;34;3,94;30;3,48;4;0,46
3554409;Terra Roxa;2013;34;3,91;30;3,45;4;0,46
3554409;Terra Roxa;2014;34;3,88;30;3,43;4;0,46
3554409;Terra Roxa;2015;34;3,85;30;3,4;4;0,45
3554409;Terra Roxa;2016;34;3,83;30;3,38;4;0,45
3554409;Terra Roxa;2017;34;3,8;30;3,36;4;0,45
3554409;Terra Roxa;2018;34;3,78;30;3,33;4;0,44
3554409;Terra Roxa;2019;34;3,75;30;3,31;4;0,44
3554508;Tietê;2010;60;1,63;35;0,95;25;0,68
3554508;Tietê;2011;60;1,61;35;0,94;25;0,67
3554508;Tietê;2012;60;1,59;35;0,93;25;0,66
3554508;Tietê;2013;68;1,78;41;1,08;27;0,71
3554508;Tietê;2014;69;1,79;42;1,09;27;0,7
3554508;Tietê;2015;69;1,77;42;1,08;27;0,69
3554508;Tietê;2016;69;1,75;42;1,07;27;0,68
3554508;Tietê;2017;57;1,43;34;0,85;23;0,58
3554508;Tietê;2018;55;1,37;33;0,82;22;0,55
3554508;Tietê;2019;55;1,35;33;0,81;22;0,54
3554607;Timburi;2010;0;0;0;0;0;0
3554607;Timburi;2011;0;0;0;0;0;0
3554607;Timburi;2012;0;0;0;0;0;0
3554607;Timburi;2013;0;0;0;0;0;0
3554607;Timburi;2014;0;0;0;0;0;0
3554607;Timburi;2015;0;0;0;0;0;0
3554607;Timburi;2016;0;0;0;0;0;0
3554607;Timburi;2017;0;0;0;0;0;0
3554607;Timburi;2018;0;0;0;0;0;0
3554607;Timburi;2019;0;0;0;0;0;0
3554656;Torre de Pedra;2010;0;0;0;0;0;0
3554656;Torre de Pedra;2011;0;0;0;0;0;0
3554656;Torre de Pedra;2012;0;0;0;0;0;0
3554656;Torre de Pedra;2013;0;0;0;0;0;0
3554656;Torre de Pedra;2014;0;0;0;0;0;0
3554656;Torre de Pedra;2015;0;0;0;0;0;0
3554656;Torre de Pedra;2016;0;0;0;0;0;0
3554656;Torre de Pedra;2017;0;0;0;0;0;0
3554656;Torre de Pedra;2018;0;0;0;0;0;0
3554656;Torre de Pedra;2019;0;0;0;0;0;0
3554706;Torrinha;2010;20;2,14;20;2,14;0;0
3554706;Torrinha;2011;20;2,14;20;2,14;0;0
3554706;Torrinha;2012;20;2,13;13;1,38;7;0,74
3554706;Torrinha;2013;20;2,12;13;1,38;7;0,74
3554706;Torrinha;2014;20;2,11;13;1,37;7;0,74
3554706;Torrinha;2015;20;2,1;13;1,37;7;0,74
3554706;Torrinha;2016;20;2,09;13;1,36;7;0,73
3554706;Torrinha;2017;20;2,08;13;1,35;7;0,73
3554706;Torrinha;2018;20;2,08;13;1,35;7;0,73
3554706;Torrinha;2019;20;2,07;13;1,34;7;0,72
;Total do Estado de São Paulo;2010;97037;2,35;60586;1,47;36451;0,88
;Total do Estado de São Paulo;2011;96210;2,31;60120;1,45;36090;0,87
;Total do Estado de São Paulo;2012;95548;2,28;59446;1,42;36102;0,86
;Total do Estado de São Paulo;2013;95679;2,26;59423;1,4;36256;0,86
;Total do Estado de São Paulo;2014;95877;2,25;58322;1,37;37555;0,88
;Total do Estado de São Paulo;2015;94502;2,2;57678;1,34;36824;0,86
;Total do Estado de São Paulo;2016;92617;2,14;55531;1,28;37086;0,86
;Total do Estado de São Paulo;2017;92291;2,11;54027;1,24;38264;0,88
;Total do Estado de São Paulo;2018;92188;2,1;53682;1,22;38506;0,88
;Total do Estado de São Paulo;2019;91023;2,05;52441;1,18;38582;0,87
3554755;Trabiju;2010;0;0;0;0;0;0
3554755;Trabiju;2011;0;0;0;0;0;0
3554755;Trabiju;2012;0;0;0;0;0;0
3554755;Trabiju;2013;0;0;0;0;0;0
3554755;Trabiju;2014;0;0;0;0;0;0
3554755;Trabiju;2015;0;0;0;0;0;0
3554755;Trabiju;2016;0;0;0;0;0;0
3554755;Trabiju;2017;0;0;0;0;0;0
3554755;Trabiju;2018;0;0;0;0;0;0
3554755;Trabiju;2019;0;0;0;0;0;0
3554805;Tremembé;2010;38;0,93;19;0,46;19;0,46
3554805;Tremembé;2011;38;0,92;19;0,46;19;0,46
3554805;Tremembé;2012;30;0,71;19;0,45;11;0,26
3554805;Tremembé;2013;30;0,7;0;0;30;0,7
3554805;Tremembé;2014;41;0,95;0;0;41;0,95
3554805;Tremembé;2015;0;0;0;0;0;0
3554805;Tremembé;2016;0;0;0;0;0;0
3554805;Tremembé;2017;0;0;0;0;0;0
3554805;Tremembé;2018;0;0;0;0;0;0
3554805;Tremembé;2019;0;0;0;0;0;0
3554904;Três Fronteiras;2010;0;0;0;0;0;0
3554904;Três Fronteiras;2011;0;0;0;0;0;0
3554904;Três Fronteiras;2012;0;0;0;0;0;0
3554904;Três Fronteiras;2013;0;0;0;0;0;0
3554904;Três Fronteiras;2014;0;0;0;0;0;0
3554904;Três Fronteiras;2015;0;0;0;0;0;0
3554904;Três Fronteiras;2016;0;0;0;0;0;0
3554904;Três Fronteiras;2017;0;0;0;0;0;0
3554904;Três Fronteiras;2018;0;0;0;0;0;0
3554904;Três Fronteiras;2019;0;0;0;0;0;0
3554953;Tuiuti;2010;0;0;0;0;0;0
3554953;Tuiuti;2011;0;0;0;0;0;0
3554953;Tuiuti;2012;0;0;0;0;0;0
3554953;Tuiuti;2013;0;0;0;0;0;0
3554953;Tuiuti;2014;0;0;0;0;0;0
3554953;Tuiuti;2015;0;0;0;0;0;0
3554953;Tuiuti;2016;0;0;0;0;0;0
3554953;Tuiuti;2017;0;0;0;0;0;0
3554953;Tuiuti;2018;0;0;0;0;0;0
3554953;Tuiuti;2019;0;0;0;0;0;0
3555000;Tupã;2010;881;13,88;830;13,08;51;0,8
3555000;Tupã;2011;872;13,75;798;12,59;74;1,17
3555000;Tupã;2012;864;13,64;791;12,49;73;1,15
3555000;Tupã;2013;864;13,66;791;12,5;73;1,15
3555000;Tupã;2014;864;13,67;791;12,52;73;1,16
3555000;Tupã;2015;864;13,69;781;12,38;83;1,32
3555000;Tupã;2016;640;10,15;571;9,06;69;1,09
3555000;Tupã;2017;440;6,98;373;5,92;67;1,06
3555000;Tupã;2018;446;7,08;330;5,24;116;1,84
3555000;Tupã;2019;446;7,09;330;5,25;116;1,84
3555109;Tupi Paulista;2010;48;3,37;30;2,1;18;1,26
3555109;Tupi Paulista;2011;48;3,34;30;2,09;18;1,25
3555109;Tupi Paulista;2012;48;3,32;30;2,08;18;1,25
3555109;Tupi Paulista;2013;48;3,3;30;2,06;18;1,24
3555109;Tupi Paulista;2014;48;3,27;30;2,05;18;1,23
3555109;Tupi Paulista;2015;48;3,25;30;2,03;18;1,22
3555109;Tupi Paulista;2016;48;3,25;30;2,03;18;1,22
3555109;Tupi Paulista;2017;48;3,24;30;2,03;18;1,22
3555109;Tupi Paulista;2018;48;3,24;30;2,02;18;1,21
3555109;Tupi Paulista;2019;48;3,23;30;2,02;18;1,21
3555208;Turiúba;2010;0;0;0;0;0;0
3555208;Turiúba;2011;0;0;0;0;0;0
3555208;Turiúba;2012;0;0;0;0;0;0
3555208;Turiúba;2013;0;0;0;0;0;0
3555208;Turiúba;2014;0;0;0;0;0;0
3555208;Turiúba;2015;0;0;0;0;0;0
3555208;Turiúba;2016;0;0;0;0;0;0
3555208;Turiúba;2017;0;0;0;0;0;0
3555208;Turiúba;2018;0;0;0;0;0;0
3555208;Turiúba;2019;0;0;0;0;0;0
3555307;Turmalina;2010;0;0;0;0;0;0
3555307;Turmalina;2011;0;0;0;0;0;0
3555307;Turmalina;2012;0;0;0;0;0;0
3555307;Turmalina;2013;0;0;0;0;0;0
3555307;Turmalina;2014;0;0;0;0;0;0
3555307;Turmalina;2015;0;0;0;0;0;0
3555307;Turmalina;2016;0;0;0;0;0;0
3555307;Turmalina;2017;0;0;0;0;0;0
3555307;Turmalina;2018;0;0;0;0;0;0
3555307;Turmalina;2019;0;0;0;0;0;0
3555356;Ubarana;2010;0;0;0;0;0;0
3555356;Ubarana;2011;0;0;0;0;0;0
3555356;Ubarana;2012;0;0;0;0;0;0
3555356;Ubarana;2013;0;0;0;0;0;0
3555356;Ubarana;2014;0;0;0;0;0;0
3555356;Ubarana;2015;0;0;0;0;0;0
3555356;Ubarana;2016;0;0;0;0;0;0
3555356;Ubarana;2017;0;0;0;0;0;0
3555356;Ubarana;2018;0;0;0;0;0;0
3555356;Ubarana;2019;0;0;0;0;0;0
3555406;Ubatuba;2010;92;1,17;68;0,86;24;0,3
3555406;Ubatuba;2011;92;1,15;68;0,85;24;0,3
3555406;Ubatuba;2012;92;1,14;68;0,84;24;0,3
3555406;Ubatuba;2013;76;0,93;69;0,84;7;0,09
3555406;Ubatuba;2014;76;0,92;67;0,81;9;0,11
3555406;Ubatuba;2015;79;0,94;74;0,88;5;0,06
3555406;Ubatuba;2016;80;0,94;74;0,87;6;0,07
3555406;Ubatuba;2017;81;0,94;71;0,83;10;0,12
3555406;Ubatuba;2018;81;0,93;71;0,82;10;0,12
3555406;Ubatuba;2019;92;1,05;74;0,84;18;0,2
3555505;Ubirajara;2010;0;0;0;0;0;0
3555505;Ubirajara;2011;0;0;0;0;0;0
3555505;Ubirajara;2012;0;0;0;0;0;0
3555505;Ubirajara;2013;0;0;0;0;0;0
3555505;Ubirajara;2014;0;0;0;0;0;0
3555505;Ubirajara;2015;0;0;0;0;0;0
3555505;Ubirajara;2016;0;0;0;0;0;0
3555505;Ubirajara;2017;0;0;0;0;0;0
3555505;Ubirajara;2018;0;0;0;0;0;0
3555505;Ubirajara;2019;0;0;0;0;0;0
3555604;Uchoa;2010;0;0;0;0;0;0
3555604;Uchoa;2011;0;0;0;0;0;0
3555604;Uchoa;2012;0;0;0;0;0;0
3555604;Uchoa;2013;0;0;0;0;0;0
3555604;Uchoa;2014;0;0;0;0;0;0
3555604;Uchoa;2015;0;0;0;0;0;0
3555604;Uchoa;2016;0;0;0;0;0;0
3555604;Uchoa;2017;0;0;0;0;0;0
3555604;Uchoa;2018;0;0;0;0;0;0
3555604;Uchoa;2019;0;0;0;0;0;0
3555703;União Paulista;2010;0;0;0;0;0;0
3555703;União Paulista;2011;0;0;0;0;0;0
3555703;União Paulista;2012;0;0;0;0;0;0
3555703;União Paulista;2013;0;0;0;0;0;0
3555703;União Paulista;2014;0;0;0;0;0;0
3555703;União Paulista;2015;0;0;0;0;0;0
3555703;União Paulista;2016;0;0;0;0;0;0
3555703;União Paulista;2017;0;0;0;0;0;0
3555703;União Paulista;2018;0;0;0;0;0;0
3555703;União Paulista;2019;0;0;0;0;0;0
3555802;Urânia;2010;38;4,3;9;1,02;29;3,28
3555802;Urânia;2011;38;4,31;9;1,02;29;3,29
3555802;Urânia;2012;38;4,32;9;1,02;29;3,3
3555802;Urânia;2013;26;2,96;24;2,74;2;0,23
3555802;Urânia;2014;26;2,97;24;2,74;2;0,23
3555802;Urânia;2015;26;2,98;24;2,75;2;0,23
3555802;Urânia;2016;26;2,99;24;2,76;2;0,23
3555802;Urânia;2017;26;2,99;24;2,76;2;0,23
3555802;Urânia;2018;26;3;24;2,77;2;0,23
3555802;Urânia;2019;26;3,01;24;2,78;2;0,23
3555901;Uru;2010;0;0;0;0;0;0
3555901;Uru;2011;0;0;0;0;0;0
3555901;Uru;2012;0;0;0;0;0;0
3555901;Uru;2013;0;0;0;0;0;0
3555901;Uru;2014;0;0;0;0;0;0
3555901;Uru;2015;0;0;0;0;0;0
3555901;Uru;2016;0;0;0;0;0;0
3555901;Uru;2017;0;0;0;0;0;0
3555901;Uru;2018;0;0;0;0;0;0
3555901;Uru;2019;0;0;0;0;0;0
3556008;Urupês;2010;34;2,68;15;1,18;19;1,5
3556008;Urupês;2011;34;2,67;15;1,18;19;1,49
3556008;Urupês;2012;34;2,66;15;1,17;19;1,48
3556008;Urupês;2013;34;2,64;15;1,17;19;1,48
3556008;Urupês;2014;34;2,63;13;1,01;21;1,63
3556008;Urupês;2015;34;2,62;13;1;21;1,62
3556008;Urupês;2016;34;2,62;13;1;21;1,62
3556008;Urupês;2017;34;2,61;13;1;21;1,61
3556008;Urupês;2018;34;2,6;13;0,99;21;1,61
3556008;Urupês;2019;34;2,59;11;0,84;23;1,75
3556107;Valentim Gentil;2010;0;0;0;0;0;0
3556107;Valentim Gentil;2011;0;0;0;0;0;0
3556107;Valentim Gentil;2012;0;0;0;0;0;0
3556107;Valentim Gentil;2013;0;0;0;0;0;0
3556107;Valentim Gentil;2014;0;0;0;0;0;0
3556107;Valentim Gentil;2015;0;0;0;0;0;0
3556107;Valentim Gentil;2016;0;0;0;0;0;0
3556107;Valentim Gentil;2017;0;0;0;0;0;0
3556107;Valentim Gentil;2018;0;0;0;0;0;0
3556107;Valentim Gentil;2019;0;0;0;0;0;0
3556206;Valinhos;2010;165;1,55;66;0,62;99;0,93
3556206;Valinhos;2011;165;1,52;66;0,61;99;0,91
3556206;Valinhos;2012;165;1,49;65;0,59;100;0,9
3556206;Valinhos;2013;169;1,5;63;0,56;106;0,94
3556206;Valinhos;2014;169;1,47;63;0,55;106;0,92
3556206;Valinhos;2015;169;1,44;63;0,54;106;0,9
3556206;Valinhos;2016;169;1,42;63;0,53;106;0,89
3556206;Valinhos;2017;140;1,16;46;0,38;94;0,78
3556206;Valinhos;2018;142;1,17;57;0,47;85;0,7
3556206;Valinhos;2019;142;1,15;57;0,46;85;0,69
3556305;Valparaíso;2010;55;2,44;31;1,38;24;1,06
3556305;Valparaíso;2011;55;2,42;31;1,37;24;1,06
3556305;Valparaíso;2012;55;2,41;31;1,36;24;1,05
3556305;Valparaíso;2013;55;2,39;31;1,35;24;1,04
3556305;Valparaíso;2014;55;2,38;31;1,34;24;1,04
3556305;Valparaíso;2015;55;2,36;31;1,33;24;1,03
3556305;Valparaíso;2016;55;2,35;31;1,32;24;1,02
3556305;Valparaíso;2017;55;2,33;31;1,32;24;1,02
3556305;Valparaíso;2018;55;2,32;31;1,31;24;1,01
3556305;Valparaíso;2019;55;2,31;31;1,3;24;1,01
3556354;Vargem;2010;0;0;0;0;0;0
3556354;Vargem;2011;0;0;0;0;0;0
3556354;Vargem;2012;0;0;0;0;0;0
3556354;Vargem;2013;0;0;0;0;0;0
3556354;Vargem;2014;0;0;0;0;0;0
3556354;Vargem;2015;0;0;0;0;0;0
3556354;Vargem;2016;0;0;0;0;0;0
3556354;Vargem;2017;0;0;0;0;0;0
3556354;Vargem;2018;0;0;0;0;0;0
3556354;Vargem;2019;0;0;0;0;0;0
3556404;Vargem Grande do Sul;2010;88;2,24;53;1,35;35;0,89
3556404;Vargem Grande do Sul;2011;88;2,23;53;1,34;35;0,89
3556404;Vargem Grande do Sul;2012;88;2,22;53;1,33;35;0,88
3556404;Vargem Grande do Sul;2013;77;1,93;47;1,18;30;0,75
3556404;Vargem Grande do Sul;2014;77;1,92;47;1,17;30;0,75
3556404;Vargem Grande do Sul;2015;77;1,9;47;1,16;30;0,74
3556404;Vargem Grande do Sul;2016;77;1,89;47;1,16;30;0,74
3556404;Vargem Grande do Sul;2017;50;1,22;31;0,76;19;0,46
3556404;Vargem Grande do Sul;2018;77;1,87;47;1,14;30;0,73
3556404;Vargem Grande do Sul;2019;50;1,21;31;0,75;19;0,46
3556453;Vargem Grande Paulista;2010;0;0;0;0;0;0
3556453;Vargem Grande Paulista;2011;0;0;0;0;0;0
3556453;Vargem Grande Paulista;2012;0;0;0;0;0;0
3556453;Vargem Grande Paulista;2013;0;0;0;0;0;0
3556453;Vargem Grande Paulista;2014;0;0;0;0;0;0
3556453;Vargem Grande Paulista;2015;0;0;0;0;0;0
3556453;Vargem Grande Paulista;2016;0;0;0;0;0;0
3556453;Vargem Grande Paulista;2017;40;0,8;0;0;40;0,8
3556453;Vargem Grande Paulista;2018;70;1,38;2;0,04;68;1,34
3556453;Vargem Grande Paulista;2019;70;1,35;2;0,04;68;1,31
3556503;Várzea Paulista;2010;31;0,29;31;0,29;0;0
3556503;Várzea Paulista;2011;31;0,29;31;0,29;0;0
3556503;Várzea Paulista;2012;36;0,33;36;0,33;0;0
3556503;Várzea Paulista;2013;27;0,24;27;0,24;0;0
3556503;Várzea Paulista;2014;29;0,26;27;0,24;2;0,02
3556503;Várzea Paulista;2015;35;0,31;27;0,24;8;0,07
3556503;Várzea Paulista;2016;35;0,3;33;0,29;2;0,02
3556503;Várzea Paulista;2017;35;0,3;31;0,27;4;0,03
3556503;Várzea Paulista;2018;39;0,33;31;0,26;8;0,07
3556503;Várzea Paulista;2019;39;0,33;31;0,26;8;0,07
3556602;Vera Cruz;2010;0;0;0;0;0;0
3556602;Vera Cruz;2011;0;0;0;0;0;0
3556602;Vera Cruz;2012;0;0;0;0;0;0
3556602;Vera Cruz;2013;0;0;0;0;0;0
3556602;Vera Cruz;2014;0;0;0;0;0;0
3556602;Vera Cruz;2015;0;0;0;0;0;0
3556602;Vera Cruz;2016;36;3,39;0;0;36;3,39
3556602;Vera Cruz;2017;36;3,4;0;0;36;3,4
3556602;Vera Cruz;2018;72;6,82;0;0;72;6,82
3556602;Vera Cruz;2019;72;6,83;0;0;72;6,83
3556701;Vinhedo;2010;95;1,5;59;0,93;36;0,57
3556701;Vinhedo;2011;95;1,46;59;0,91;36;0,55
3556701;Vinhedo;2012;95;1,43;59;0,89;36;0,54
3556701;Vinhedo;2013;95;1,4;0;0;95;1,4
3556701;Vinhedo;2014;6;0,09;4;0,06;2;0,03
3556701;Vinhedo;2015;32;0,45;20;0,28;12;0,17
3556701;Vinhedo;2016;67;0,93;48;0,66;19;0,26
3556701;Vinhedo;2017;88;1,2;55;0,75;33;0,45
3556701;Vinhedo;2018;78;1,04;49;0,65;29;0,39
3556701;Vinhedo;2019;85;1,12;62;0,81;23;0,3
3556800;Viradouro;2010;54;3,12;20;1,16;34;1,97
3556800;Viradouro;2011;54;3,1;20;1,15;34;1,95
3556800;Viradouro;2012;54;3,08;20;1,14;34;1,94
3556800;Viradouro;2013;48;2,72;30;1,7;18;1,02
3556800;Viradouro;2014;48;2,71;30;1,69;18;1,01
3556800;Viradouro;2015;48;2,69;30;1,68;18;1,01
3556800;Viradouro;2016;48;2,67;30;1,67;18;1
3556800;Viradouro;2017;48;2,66;30;1,66;18;1
3556800;Viradouro;2018;48;2,64;30;1,65;18;0,99
3556800;Viradouro;2019;48;2,63;30;1,64;18;0,99
3556909;Vista Alegre do Alto;2010;13;1,89;13;1,89;0;0
3556909;Vista Alegre do Alto;2011;9;1,29;9;1,29;0;0
3556909;Vista Alegre do Alto;2012;9;1,27;9;1,27;0;0
3556909;Vista Alegre do Alto;2013;9;1,24;9;1,24;0;0
3556909;Vista Alegre do Alto;2014;9;1,22;9;1,22;0;0
3556909;Vista Alegre do Alto;2015;0;0;0;0;0;0
3556909;Vista Alegre do Alto;2016;0;0;0;0;0;0
3556909;Vista Alegre do Alto;2017;0;0;0;0;0;0
3556909;Vista Alegre do Alto;2018;0;0;0;0;0;0
3556909;Vista Alegre do Alto;2019;0;0;0;0;0;0
3556958;Vitória Brasil;2010;0;0;0;0;0;0
3556958;Vitória Brasil;2011;0;0;0;0;0;0
3556958;Vitória Brasil;2012;0;0;0;0;0;0
3556958;Vitória Brasil;2013;0;0;0;0;0;0
3556958;Vitória Brasil;2014;0;0;0;0;0;0
3556958;Vitória Brasil;2015;0;0;0;0;0;0
3556958;Vitória Brasil;2016;0;0;0;0;0;0
3556958;Vitória Brasil;2017;0;0;0;0;0;0
3556958;Vitória Brasil;2018;0;0;0;0;0;0
3556958;Vitória Brasil;2019;0;0;0;0;0;0
3557006;Votorantim;2010;171;1,57;84;0,77;87;0,8
3557006;Votorantim;2011;146;1,33;84;0,76;62;0,56
3557006;Votorantim;2012;146;1,32;84;0,76;62;0,56
3557006;Votorantim;2013;146;1,3;84;0,75;62;0,55
3557006;Votorantim;2014;150;1,32;88;0,78;62;0,55
3557006;Votorantim;2015;150;1,31;88;0,77;62;0,54
3557006;Votorantim;2016;172;1,49;88;0,76;84;0,73
3557006;Votorantim;2017;172;1,48;88;0,75;84;0,72
3557006;Votorantim;2018;177;1,5;53;0,45;124;1,05
3557006;Votorantim;2019;212;1,79;53;0,45;159;1,34
3557105;Votuporanga;2010;256;3,03;118;1,39;138;1,63
3557105;Votuporanga;2011;240;2,81;118;1,38;122;1,43
3557105;Votuporanga;2012;240;2,79;118;1,37;122;1,42
3557105;Votuporanga;2013;240;2,76;118;1,36;122;1,4
3557105;Votuporanga;2014;238;2,71;123;1,4;115;1,31
3557105;Votuporanga;2015;208;2,35;125;1,41;83;0,94
3557105;Votuporanga;2016;204;2,29;115;1,29;89;1
3557105;Votuporanga;2017;204;2,27;115;1,28;89;0,99
3557105;Votuporanga;2018;205;2,27;115;1,27;90;1
3557105;Votuporanga;2019;205;2,25;115;1,26;90;0,99
3557154;Zacarias;2010;0;0;0;0;0;0
3557154;Zacarias;2011;0;0;0;0;0;0
3557154;Zacarias;2012;0;0;0;0;0;0
3557154;Zacarias;2013;0;0;0;0;0;0
3557154;Zacarias;2014;0;0;0;0;0;0
3557154;Zacarias;2015;0;0;0;0;0;0
3557154;Zacarias;2016;0;0;0;0;0;0
3557154;Zacarias;2017;0;0;0;0;0;0
3557154;Zacarias;2018;0;0;0;0;0;0
3557154;Zacarias;2019;0;0;0;0;0;0
